id,player_name,age,games,games_started,minutes_played,field_goals,field_attempts,field_percent,three_fg,three_attempts,three_percent,two_fg,two_attempts,two_percent,effect_fg_percent,ft,fta,ft_percent,ORB,DRB,TRB,AST,STL,BLK,TOV,PF,PTS,team,season
7542,Aaron Brooks,25,82,82,2919,575,1331,0.432,209,525,0.398,366,806,0.454,0.511,245,298,0.822,54,161,215,434,69,14,232,199,1604,HOU,2010
7543,Luis Scola,29,82,82,2671,560,1090,0.514,1,5,0.200,559,1085,0.515,0.514,208,267,0.779,175,530,705,169,63,26,163,246,1329,HOU,2010
7544,Trevor Ariza,24,72,71,2629,394,999,0.394,136,407,0.334,258,592,0.436,0.462,148,228,0.649,78,325,403,276,126,40,161,162,1072,HOU,2010
7545,Shane Battier,31,67,62,2168,178,447,0.398,101,279,0.362,77,168,0.458,0.511,77,106,0.726,74,238,312,164,53,76,64,139,534,HOU,2010
7546,Chuck Hayes,26,82,82,1773,161,329,0.489,0,0,,161,329,0.489,0.489,36,66,0.545,151,314,465,139,73,43,74,219,358,HOU,2010
7547,Kyle Lowry,23,68,0,1651,184,464,0.397,37,136,0.272,147,328,0.448,0.436,215,260,0.827,91,156,247,305,60,9,116,173,620,HOU,2010
7548,Chase Budinger,21,74,4,1488,249,565,0.441,92,249,0.369,157,316,0.497,0.522,67,87,0.770,38,182,220,88,34,11,48,85,657,HOU,2010
7549,Carl Landry,26,52,1,1415,302,552,0.547,0,0,,302,552,0.547,0.547,235,280,0.839,122,164,286,40,28,46,86,146,839,HOU,2010
7550,David Andersen,29,63,0,891,147,340,0.432,27,78,0.346,120,262,0.458,0.472,46,67,0.687,54,154,208,44,15,12,37,119,367,HOU,2010
7551,Kevin Martin,26,24,22,859,154,354,0.435,31,100,0.310,123,254,0.484,0.479,171,185,0.924,9,61,70,54,23,2,57,45,510,HOU,2010
7552,Jordan Hill,22,23,0,372,58,109,0.532,0,0,,58,109,0.532,0.532,31,47,0.660,44,70,114,13,4,12,18,55,147,HOU,2010
7553,Jared Jeffries,28,18,0,332,36,84,0.429,1,9,0.111,35,75,0.467,0.435,15,27,0.556,31,34,65,18,9,13,14,46,88,HOU,2010
7554,Jermaine Taylor,23,31,4,303,45,119,0.378,5,22,0.227,40,97,0.412,0.399,33,46,0.717,21,25,46,16,10,3,19,15,128,HOU,2010
7555,Garrett Temple,23,9,0,118,13,29,0.448,3,12,0.250,10,17,0.588,0.500,16,24,0.667,2,12,14,7,4,4,14,16,45,HOU,2010
7556,Mike Harris,26,8,0,82,10,27,0.370,0,1,0.000,10,26,0.385,0.370,5,9,0.556,9,11,20,3,4,1,9,10,25,HOU,2010
7557,Joey Dorsey,26,7,0,54,5,11,0.455,0,0,,5,11,0.455,0.455,1,2,0.500,11,14,25,2,2,1,4,12,11,HOU,2010
7558,Tracy McGrady,30,6,0,46,7,19,0.368,1,2,0.500,6,17,0.353,0.395,4,6,0.667,0,5,5,6,0,2,1,2,19,HOU,2010
7559,Brian Cook,29,15,0,44,7,23,0.304,2,9,0.222,5,14,0.357,0.348,5,7,0.714,1,8,9,1,0,2,6,5,21,HOU,2010
7560,Hilton Armstrong,25,9,0,40,5,17,0.294,0,1,0.000,5,16,0.313,0.294,0,2,0.000,5,1,6,3,5,0,5,10,10,HOU,2010
7561,Will Conroy,27,5,0,36,3,10,0.300,0,3,0.000,3,7,0.429,0.300,0,2,0.000,0,3,3,7,0,0,4,5,6,HOU,2010
7562,Pops Mensah-Bonsu,26,4,0,13,1,4,0.250,0,0,,1,4,0.250,0.250,3,6,0.500,1,3,4,1,1,1,0,3,5,HOU,2010
7563,Andre Iguodala,26,82,82,3193,496,1120,0.443,94,303,0.310,402,817,0.492,0.485,315,430,0.733,82,447,529,472,141,55,218,145,1401,PHI,2010
7564,Elton Brand,30,76,57,2297,412,858,0.480,0,1,0.000,412,857,0.481,0.480,172,233,0.738,179,282,461,109,82,80,131,232,996,PHI,2010
7565,Thaddeus Young,21,67,45,2145,382,813,0.470,48,138,0.348,334,675,0.495,0.499,114,165,0.691,130,220,350,97,81,15,126,133,926,PHI,2010
7566,Samuel Dalembert,28,82,80,2124,285,523,0.545,0,0,,285,523,0.545,0.545,97,133,0.729,239,545,784,64,42,151,123,252,667,PHI,2010
7567,Lou Williams,23,64,38,1912,318,677,0.470,70,206,0.340,248,471,0.527,0.521,192,233,0.824,25,162,187,268,80,15,106,110,898,PHI,2010
7568,Jrue Holiday,19,73,51,1767,230,520,0.442,62,159,0.390,168,361,0.465,0.502,65,86,0.756,56,135,191,280,79,18,156,153,587,PHI,2010
7569,Willie Green,28,73,18,1553,248,543,0.457,47,136,0.346,201,407,0.494,0.500,95,114,0.833,20,109,129,152,32,11,67,135,638,PHI,2010
7570,Marreese Speights,22,62,1,1016,212,444,0.477,0,5,0.000,212,439,0.483,0.477,108,145,0.745,85,167,252,36,29,34,51,152,532,PHI,2010
7571,Jason Kapono,28,57,12,976,126,301,0.419,63,171,0.368,63,130,0.485,0.523,9,15,0.600,14,52,66,39,21,6,34,80,324,PHI,2010
7572,Rodney Carney,25,68,0,857,113,282,0.401,41,135,0.304,72,147,0.490,0.473,52,63,0.825,26,111,137,37,25,20,21,79,319,PHI,2010
7573,Allen Iverson,34,25,24,798,121,290,0.417,8,24,0.333,113,266,0.425,0.431,98,119,0.824,15,60,75,102,18,2,57,43,348,PHI,2010
7574,Jason Smith,23,56,2,658,75,174,0.431,10,29,0.345,65,145,0.448,0.460,29,42,0.690,54,81,135,33,21,28,35,110,189,PHI,2010
7575,Royal Ivey,28,26,0,236,26,55,0.473,12,24,0.500,14,31,0.452,0.582,6,7,0.857,5,21,26,17,10,2,5,25,70,PHI,2010
7576,Jodie Meeks,22,19,0,233,40,91,0.440,19,50,0.380,21,41,0.512,0.544,13,18,0.722,4,23,27,17,5,1,5,19,112,PHI,2010
7577,Primož Brezec,30,7,0,36,2,13,0.154,0,0,,2,13,0.154,0.154,1,2,0.500,6,6,12,0,1,1,0,9,5,PHI,2010
7578,Francisco Elson,33,1,0,4,1,2,0.500,0,0,,1,2,0.500,0.500,0,3,0.000,1,0,1,0,0,0,0,0,2,PHI,2010
7579,Rajon Rondo,23,81,81,2963,459,904,0.508,17,80,0.213,442,824,0.536,0.517,175,282,0.621,100,260,360,794,189,11,246,198,1110,BOS,2010
7580,Ray Allen,34,80,80,2819,464,973,0.477,145,399,0.363,319,574,0.556,0.551,231,253,0.913,45,208,253,210,64,25,129,182,1304,BOS,2010
7581,Paul Pierce,32,71,71,2411,409,867,0.472,109,263,0.414,300,604,0.497,0.535,369,433,0.852,39,271,310,218,84,31,166,196,1296,BOS,2010
7582,Kendrick Perkins,25,78,78,2154,314,522,0.602,0,3,0.000,314,519,0.605,0.602,163,280,0.582,155,440,595,80,26,132,165,219,791,BOS,2010
7583,Kevin Garnett,33,69,69,2060,402,772,0.521,1,5,0.200,401,767,0.523,0.521,185,221,0.837,78,428,506,185,68,57,101,170,990,BOS,2010
7584,Rasheed Wallace,35,79,13,1780,266,650,0.409,82,290,0.283,184,360,0.511,0.472,96,125,0.768,42,283,325,80,80,70,63,222,710,BOS,2010
7585,Marquis Daniels,29,51,4,937,124,249,0.498,6,28,0.214,118,221,0.534,0.510,34,56,0.607,27,68,95,66,27,6,42,91,288,BOS,2010
7586,Glen Davis,24,54,1,933,122,279,0.437,0,4,0.000,122,275,0.444,0.437,96,138,0.696,101,104,205,35,21,14,53,132,340,BOS,2010
7587,Tony Allen,28,54,8,889,129,253,0.510,0,5,0.000,129,248,0.520,0.510,72,119,0.605,52,93,145,72,59,19,66,109,330,BOS,2010
7588,Eddie House,31,50,0,846,129,322,0.401,64,167,0.383,65,155,0.419,0.500,36,40,0.900,7,62,69,48,28,7,27,61,358,BOS,2010
7589,Shelden Williams,26,54,0,597,63,121,0.521,0,1,0.000,63,120,0.525,0.521,75,98,0.765,47,99,146,21,13,21,30,85,201,BOS,2010
7590,Brian Scalabrine,31,52,3,472,29,85,0.341,16,49,0.327,13,36,0.361,0.435,4,6,0.667,9,39,48,27,9,4,17,59,78,BOS,2010
7591,Nate Robinson,25,26,0,382,63,157,0.401,36,87,0.414,27,70,0.386,0.516,8,13,0.615,5,33,38,51,22,0,20,50,170,BOS,2010
7592,Michael Finley,36,21,1,314,44,87,0.506,19,41,0.463,25,46,0.543,0.615,2,6,0.333,1,32,33,24,4,2,8,21,109,BOS,2010
7593,J.R. Giddens,24,21,1,99,9,21,0.429,0,2,0.000,9,19,0.474,0.429,6,12,0.500,4,16,20,6,4,1,7,10,24,BOS,2010
7594,Lester Hudson,25,16,0,70,7,18,0.389,3,5,0.600,4,13,0.308,0.472,5,6,0.833,3,5,8,8,3,2,9,7,22,BOS,2010
7595,Henry Walker,22,8,0,29,3,6,0.500,0,0,,3,6,0.500,0.500,2,2,1.000,0,5,5,3,0,0,2,4,8,BOS,2010
7596,Oliver Lafayette,25,1,0,22,3,6,0.500,1,2,0.500,2,4,0.500,0.583,0,0,,1,3,4,2,0,0,1,0,7,BOS,2010
7597,Marcus Landry,24,1,0,3,0,2,0.000,0,2,0.000,0,0,,0.000,0,0,,0,0,0,0,0,0,0,0,0,BOS,2010
7598,David Lee,26,81,81,3019,686,1258,0.545,0,8,0.000,686,1250,0.549,0.545,268,330,0.812,228,721,949,295,85,40,189,257,1640,NYK,2010
7599,Danilo Gallinari,21,81,74,2747,392,927,0.423,186,488,0.381,206,439,0.469,0.523,251,307,0.818,65,333,398,135,75,58,110,191,1221,NYK,2010
7600,Wilson Chandler,22,65,64,2320,412,860,0.479,40,150,0.267,372,710,0.524,0.502,129,160,0.806,93,255,348,138,46,49,108,184,993,NYK,2010
7601,Al Harrington,29,72,15,2195,448,1030,0.435,140,409,0.342,308,621,0.496,0.503,240,317,0.757,88,317,405,110,62,26,132,209,1276,NYK,2010
7602,Chris Duhon,27,67,59,2072,168,451,0.373,90,258,0.349,78,193,0.404,0.472,68,95,0.716,28,150,178,378,59,3,110,83,494,NYK,2010
7603,Jared Jeffries,28,52,37,1462,102,230,0.443,20,62,0.323,82,168,0.488,0.487,60,93,0.645,99,124,223,83,53,58,62,157,284,NYK,2010
7604,Toney Douglas,23,56,12,1087,179,391,0.458,68,175,0.389,111,216,0.514,0.545,55,68,0.809,40,68,108,112,42,3,55,116,481,NYK,2010
7605,Larry Hughes,31,31,14,820,102,279,0.366,28,97,0.289,74,182,0.407,0.416,65,79,0.823,16,94,110,109,40,11,56,53,297,NYK,2010
7606,Henry Walker,22,27,13,739,117,226,0.518,50,116,0.431,67,110,0.609,0.628,37,47,0.787,15,68,83,37,23,3,26,79,321,NYK,2010
7607,Nate Robinson,25,30,2,733,152,336,0.452,51,136,0.375,101,200,0.505,0.528,42,54,0.778,23,49,72,112,27,5,53,66,397,NYK,2010
7608,Tracy McGrady,30,24,24,627,84,216,0.389,15,62,0.242,69,154,0.448,0.424,43,57,0.754,22,67,89,93,15,12,43,38,226,NYK,2010
7609,Sergio Rodríguez,23,27,8,531,79,161,0.491,17,49,0.347,62,112,0.554,0.543,25,31,0.806,9,30,39,91,21,2,55,38,200,NYK,2010
7610,Eddie House,31,18,0,371,44,133,0.331,15,60,0.250,29,73,0.397,0.387,12,12,1.000,6,34,40,37,12,0,20,20,115,NYK,2010
7611,Jonathan Bender,29,25,1,292,40,100,0.400,14,39,0.359,26,61,0.426,0.470,24,26,0.923,15,37,52,16,2,17,28,33,118,NYK,2010
7612,Jordan Hill,22,24,0,252,41,92,0.446,0,2,0.000,41,90,0.456,0.446,15,21,0.714,32,29,61,7,10,9,12,37,97,NYK,2010
7613,Earl Barron,28,7,6,232,30,68,0.441,0,0,,30,68,0.441,0.441,22,29,0.759,31,46,77,8,4,4,11,24,82,NYK,2010
7614,J.R. Giddens,24,11,0,140,19,39,0.487,0,8,0.000,19,31,0.613,0.487,7,11,0.636,12,19,31,7,5,1,10,19,45,NYK,2010
7615,Marcus Landry,24,17,0,108,16,41,0.390,9,26,0.346,7,15,0.467,0.500,3,5,0.600,5,14,19,0,1,2,6,14,44,NYK,2010
7616,Darko Miličić,24,8,0,71,8,17,0.471,0,0,,8,17,0.471,0.471,0,0,,5,13,18,4,4,1,2,7,16,NYK,2010
7617,Eddy Curry,27,7,0,62,8,21,0.381,0,0,,8,21,0.381,0.381,10,17,0.588,4,9,13,0,0,1,13,13,26,NYK,2010
7618,Brook Lopez,21,82,82,3027,563,1129,0.499,0,2,0.000,563,1127,0.500,0.499,416,509,0.817,270,439,709,187,55,139,204,251,1542,NJN,2010
7619,Courtney Lee,24,71,66,2375,338,775,0.436,76,225,0.338,262,550,0.476,0.485,133,153,0.869,60,192,252,121,93,20,76,130,885,NJN,2010
7620,Devin Harris,26,64,61,2221,356,884,0.403,60,217,0.276,296,667,0.444,0.437,308,386,0.798,24,179,203,423,79,18,181,178,1080,NJN,2010
7621,Terrence Williams,22,78,9,1764,261,651,0.401,31,100,0.310,230,551,0.417,0.425,103,144,0.715,46,302,348,223,43,10,124,126,656,NJN,2010
7622,Chris Douglas-Roberts,23,67,38,1730,255,573,0.445,14,54,0.259,241,519,0.464,0.457,133,157,0.847,45,153,198,93,55,19,97,101,657,NJN,2010
7623,Yi Jianlian,22,52,51,1655,227,563,0.403,15,41,0.366,212,522,0.406,0.417,154,193,0.798,115,257,372,47,37,52,77,170,623,NJN,2010
7624,Trenton Hassell,30,52,31,1106,90,219,0.411,0,5,0.000,90,214,0.421,0.411,52,69,0.754,56,96,152,50,17,9,47,91,232,NJN,2010
7625,Josh Boone,25,63,28,1045,117,223,0.525,0,0,,117,223,0.525,0.525,19,58,0.328,124,191,315,29,30,48,37,111,253,NJN,2010
7626,Jarvis Hayes,28,45,19,1033,138,328,0.421,60,179,0.335,78,149,0.523,0.512,14,18,0.778,9,99,108,40,29,9,28,91,350,NJN,2010
7627,Keyon Dooling,29,53,8,971,129,324,0.398,59,157,0.376,70,167,0.419,0.489,47,61,0.770,8,46,54,135,34,0,59,82,364,NJN,2010
7628,Kris Humphries,24,44,0,906,127,293,0.433,0,1,0.000,127,292,0.435,0.433,102,146,0.699,82,201,283,25,29,37,53,102,356,NJN,2010
7629,Rafer Alston,33,27,13,766,95,277,0.343,28,87,0.322,67,190,0.353,0.394,44,54,0.815,9,66,75,104,27,5,61,50,262,NJN,2010
7630,Bobby Simmons,29,23,2,395,42,117,0.359,20,63,0.317,22,54,0.407,0.444,18,20,0.900,11,52,63,15,15,3,19,52,122,NJN,2010
7631,Sean Williams,23,20,0,227,21,49,0.429,0,1,0.000,21,48,0.438,0.429,10,19,0.526,21,25,46,1,8,19,20,41,52,NJN,2010
7632,Chris Quinn,26,25,0,223,20,56,0.357,10,32,0.313,10,24,0.417,0.446,6,6,1.000,1,15,16,29,9,1,10,15,56,NJN,2010
7633,Eduardo Nájera,33,13,2,204,20,53,0.377,3,17,0.176,17,36,0.472,0.406,6,12,0.500,12,26,38,15,9,2,12,33,49,NJN,2010
7634,Tony Battie,33,15,0,134,14,40,0.350,1,4,0.250,13,36,0.361,0.363,7,10,0.700,4,19,23,3,4,2,3,19,36,NJN,2010
7635,Andrea Bargnani,24,80,80,2799,537,1143,0.470,121,325,0.372,416,818,0.509,0.523,181,234,0.774,105,388,493,93,25,111,120,215,1376,TOR,2010
7636,Chris Bosh,25,70,70,2526,600,1158,0.518,8,22,0.364,592,1136,0.521,0.522,470,590,0.797,205,554,759,166,43,68,169,170,1678,TOR,2010
7637,Hedo Türkoğlu,30,74,69,2272,276,674,0.409,108,289,0.374,168,385,0.436,0.490,175,226,0.774,42,301,343,304,55,32,125,220,835,TOR,2010
7638,Jarrett Jack,26,82,43,2243,323,671,0.481,82,199,0.412,241,472,0.511,0.542,203,241,0.842,30,192,222,413,60,6,163,151,931,TOR,2010
7639,José Calderón,28,68,39,1817,274,568,0.482,68,171,0.398,206,397,0.519,0.542,83,104,0.798,23,119,142,404,47,7,99,135,699,TOR,2010
7640,DeMar DeRozan,20,77,65,1664,255,512,0.498,4,16,0.250,251,496,0.506,0.502,148,194,0.763,66,157,223,53,43,18,62,176,662,TOR,2010
7641,Amir Johnson,22,82,5,1453,208,334,0.623,0,4,0.000,208,330,0.630,0.623,95,149,0.638,154,241,395,48,44,66,63,255,511,TOR,2010
7000,Kevin Martin,27,80,80,2603,553,1267,0.436,176,459,0.383,377,808,0.467,0.506,594,669,0.888,28,230,258,198,80,15,184,155,1876,HOU,2011
7001,Kyle Lowry,24,75,71,2563,345,809,0.426,129,343,0.376,216,466,0.464,0.506,192,251,0.765,89,220,309,500,102,23,158,207,1011,HOU,2011
7002,Luis Scola,30,74,74,2412,569,1129,0.504,0,3,0.000,569,1126,0.505,0.504,214,290,0.738,147,459,606,185,48,44,147,227,1352,HOU,2011
7003,Chuck Hayes,27,74,63,2079,244,463,0.527,0,2,0.000,244,461,0.529,0.527,94,142,0.662,219,380,599,202,79,49,86,200,582,HOU,2011
7004,Shane Battier,32,59,59,1818,186,408,0.456,88,225,0.391,98,183,0.536,0.564,49,76,0.645,58,223,281,153,53,71,63,127,509,HOU,2011
7005,Chase Budinger,22,78,22,1738,279,656,0.425,89,274,0.325,190,382,0.497,0.493,118,138,0.855,52,229,281,127,41,18,67,114,765,HOU,2011
7006,Courtney Lee,25,81,1,1723,253,576,0.439,71,174,0.408,182,402,0.453,0.501,95,120,0.792,51,158,209,100,58,18,68,102,672,HOU,2011
7007,Jordan Hill,23,72,11,1125,173,352,0.491,0,2,0.000,173,350,0.494,0.491,60,85,0.706,128,178,306,29,14,52,62,157,406,HOU,2011
7008,Brad Miller,34,60,5,1015,132,296,0.446,40,107,0.374,92,189,0.487,0.514,78,94,0.830,44,178,222,145,28,21,54,98,382,HOU,2011
7009,Patrick Patterson,21,52,6,868,149,267,0.558,0,2,0.000,149,265,0.562,0.558,30,42,0.714,86,114,200,41,17,37,31,77,328,HOU,2011
7010,Aaron Brooks,26,34,7,811,134,387,0.346,48,169,0.284,86,218,0.394,0.408,78,83,0.940,11,40,51,129,21,2,55,69,394,HOU,2011
7011,Goran Dragić,24,22,3,378,59,125,0.472,28,54,0.519,31,71,0.437,0.584,24,36,0.667,12,44,56,55,14,4,21,35,170,HOU,2011
7012,Ish Smith,22,28,3,329,32,83,0.386,3,8,0.375,29,75,0.387,0.404,7,10,0.700,6,36,42,64,13,2,26,26,74,HOU,2011
7013,Jared Jeffries,29,18,0,138,11,36,0.306,1,6,0.167,10,30,0.333,0.319,4,10,0.400,20,15,35,11,7,3,4,21,27,HOU,2011
7014,Yao Ming,30,5,5,91,18,37,0.486,0,0,,18,37,0.486,0.486,15,16,0.938,7,20,27,4,0,8,7,13,51,HOU,2011
7015,Terrence Williams,23,11,0,84,14,42,0.333,2,10,0.200,12,32,0.375,0.357,9,11,0.818,1,14,15,7,4,0,8,4,39,HOU,2011
7016,Jermaine Taylor,24,8,0,77,16,32,0.500,2,5,0.400,14,27,0.519,0.531,5,6,0.833,1,8,9,2,2,2,6,4,39,HOU,2011
7017,Mike Harris,27,4,0,16,3,6,0.500,0,0,,3,6,0.500,0.500,2,4,0.500,2,3,5,1,0,1,1,2,8,HOU,2011
7018,DeMarre Carroll,24,5,0,11,0,3,0.000,0,0,,0,3,0.000,0.000,0,0,,0,0,0,2,0,0,0,0,0,HOU,2011
7019,Hasheem Thabeet,23,2,0,4,0,1,0.000,0,0,,0,1,0.000,0.000,0,0,,0,0,0,0,0,1,0,3,0,HOU,2011
7020,Jrue Holiday,20,82,82,2901,446,999,0.446,81,222,0.365,365,777,0.470,0.487,172,209,0.823,68,264,332,531,120,29,218,203,1145,PHI,2011
7021,Elton Brand,31,81,81,2809,502,981,0.512,0,1,0.000,502,980,0.512,0.512,213,273,0.780,237,439,676,120,92,106,101,244,1217,PHI,2011
7022,Andre Iguodala,27,67,67,2469,338,759,0.445,61,181,0.337,277,578,0.479,0.486,208,300,0.693,61,326,387,422,101,38,138,109,945,PHI,2011
7023,Thaddeus Young,22,82,1,2135,458,847,0.541,6,22,0.273,452,825,0.548,0.544,123,174,0.707,153,281,434,82,90,26,99,170,1045,PHI,2011
7024,Jodie Meeks,23,74,64,2062,242,570,0.425,138,348,0.397,104,222,0.468,0.546,152,170,0.894,21,150,171,78,63,4,60,97,774,PHI,2011
7025,Evan Turner,22,78,14,1797,225,529,0.425,14,44,0.318,211,485,0.435,0.439,101,125,0.808,42,264,306,159,49,14,80,138,565,PHI,2011
7026,Lou Williams,24,75,0,1747,323,795,0.406,88,253,0.348,235,542,0.434,0.462,293,356,0.823,32,117,149,252,47,17,102,128,1027,PHI,2011
7027,Spencer Hawes,22,81,81,1718,264,568,0.465,9,37,0.243,255,531,0.480,0.473,47,88,0.534,129,336,465,121,29,71,97,201,584,PHI,2011
7028,Andrés Nocioni,31,54,17,931,118,277,0.426,42,118,0.356,76,159,0.478,0.502,49,61,0.803,19,150,169,45,14,15,47,100,327,PHI,2011
7029,Marreese Speights,23,64,1,734,144,291,0.495,1,4,0.250,143,287,0.498,0.497,55,73,0.753,64,146,210,30,8,19,40,120,344,PHI,2011
7030,Tony Battie,34,38,0,377,45,96,0.469,2,3,0.667,43,93,0.462,0.479,8,14,0.571,17,82,99,12,5,15,12,59,100,PHI,2011
7031,Jason Kapono,29,24,2,112,7,28,0.250,1,8,0.125,6,20,0.300,0.268,1,2,0.500,3,8,11,4,2,1,2,4,16,PHI,2011
7032,Darius Songaila,32,10,0,71,7,15,0.467,0,0,,7,15,0.467,0.467,2,4,0.500,2,8,10,2,0,0,4,16,16,PHI,2011
7033,Antonio Daniels,35,4,0,35,2,5,0.400,0,2,0.000,2,3,0.667,0.400,2,2,1.000,0,5,5,2,0,0,1,0,6,PHI,2011
7034,Craig Brackins,23,3,0,33,4,16,0.250,0,5,0.000,4,11,0.364,0.250,0,0,,2,2,4,1,1,0,0,3,8,PHI,2011
7035,Ray Allen,35,80,80,2890,480,978,0.491,168,378,0.444,312,600,0.520,0.577,193,219,0.881,51,223,274,219,77,16,117,147,1321,BOS,2011
7036,Paul Pierce,33,80,80,2774,507,1021,0.497,111,297,0.374,396,724,0.547,0.551,386,449,0.860,34,396,430,260,80,51,171,231,1511,BOS,2011
7037,Rajon Rondo,24,68,68,2527,318,670,0.475,10,43,0.233,308,627,0.491,0.482,75,132,0.568,87,210,297,760,153,11,234,120,721,BOS,2011
7038,Glen Davis,25,78,13,2298,359,801,0.448,2,15,0.133,357,786,0.454,0.449,195,265,0.736,101,324,425,92,78,30,85,231,915,BOS,2011
7039,Kevin Garnett,34,71,71,2220,434,822,0.528,1,5,0.200,433,817,0.530,0.529,187,217,0.862,83,548,631,171,95,57,115,148,1056,BOS,2011
7040,Nate Robinson,26,55,11,983,146,361,0.404,63,192,0.328,83,169,0.491,0.492,33,40,0.825,15,74,89,105,29,4,66,107,388,BOS,2011
7041,Marquis Daniels,30,49,0,938,114,232,0.491,4,21,0.190,110,211,0.521,0.500,39,57,0.684,24,89,113,64,39,22,38,63,271,BOS,2011
7042,Shaquille O'Neal,38,37,36,752,134,201,0.667,0,0,,134,201,0.667,0.667,73,131,0.557,48,130,178,26,16,42,56,120,341,BOS,2011
7043,Jeff Green,24,26,2,612,98,202,0.485,8,27,0.296,90,175,0.514,0.505,50,63,0.794,16,70,86,19,13,16,23,68,254,BOS,2011
7044,Von Wafer,25,58,2,553,67,159,0.421,18,67,0.269,49,92,0.533,0.478,32,38,0.842,7,42,49,35,18,5,20,39,184,BOS,2011
7045,Nenad Krstić,27,24,20,553,79,147,0.537,0,0,,79,147,0.537,0.537,60,80,0.750,47,81,128,8,8,8,23,77,218,BOS,2011
7046,Semih Erden,24,37,7,531,58,97,0.598,0,0,,58,97,0.598,0.598,34,54,0.630,31,76,107,19,13,21,32,92,150,BOS,2011
7047,Delonte West,27,24,2,453,55,120,0.458,12,33,0.364,43,87,0.494,0.508,13,15,0.867,6,31,37,64,20,10,30,29,135,BOS,2011
7048,Jermaine O'Neal,32,24,10,431,50,109,0.459,0,1,0.000,50,108,0.463,0.459,29,43,0.674,25,63,88,12,2,30,27,65,129,BOS,2011
7049,Kendrick Perkins,26,12,7,313,32,59,0.542,0,0,,32,59,0.542,0.542,23,40,0.575,23,74,97,10,2,10,25,37,87,BOS,2011
7050,Luke Harangody,23,28,0,241,28,71,0.394,2,10,0.200,26,61,0.426,0.408,5,8,0.625,17,38,55,10,4,7,5,36,63,BOS,2011
7051,Carlos Arroyo,31,15,1,190,11,35,0.314,3,5,0.600,8,30,0.267,0.357,11,12,0.917,7,16,23,25,7,0,17,11,36,BOS,2011
7052,Troy Murphy,30,17,0,178,16,38,0.421,1,10,0.100,15,28,0.536,0.434,11,13,0.846,11,27,38,6,8,1,7,19,44,BOS,2011
7053,Avery Bradley,20,31,0,162,23,67,0.343,0,5,0.000,23,62,0.371,0.343,6,12,0.500,4,13,17,12,9,0,16,20,52,BOS,2011
7054,Sasha Pavlović,27,17,0,149,12,26,0.462,5,10,0.500,7,16,0.438,0.558,2,5,0.400,1,13,14,3,5,0,6,15,31,BOS,2011
7055,Chris Johnson,25,4,0,32,2,3,0.667,0,0,,2,3,0.667,0.667,2,2,1.000,1,4,5,1,0,3,2,3,6,BOS,2011
7056,Amar'e Stoudemire,28,78,78,2870,744,1482,0.502,10,23,0.435,734,1459,0.503,0.505,473,597,0.792,198,438,636,202,71,150,250,274,1971,NYK,2011
7057,Landry Fields,22,82,81,2541,299,602,0.497,86,219,0.393,213,383,0.556,0.568,113,147,0.769,105,416,521,155,80,17,107,114,797,NYK,2011
7058,Raymond Felton,26,54,54,2074,339,801,0.423,88,268,0.328,251,533,0.471,0.478,157,181,0.867,40,154,194,488,97,11,176,113,923,NYK,2011
7059,Toney Douglas,24,81,9,1971,314,755,0.416,143,383,0.373,171,372,0.460,0.511,85,107,0.794,65,179,244,244,89,4,89,177,856,NYK,2011
7060,Wilson Chandler,23,51,30,1759,328,712,0.461,86,245,0.351,242,467,0.518,0.521,96,119,0.807,62,241,303,86,34,70,67,152,838,NYK,2011
7061,Danilo Gallinari,22,48,48,1671,211,509,0.415,83,239,0.347,128,270,0.474,0.496,259,290,0.893,48,181,229,82,38,18,58,117,764,NYK,2011
7062,Shawne Williams,24,64,11,1323,164,385,0.426,85,212,0.401,79,173,0.457,0.536,41,49,0.837,60,179,239,47,39,51,46,164,454,NYK,2011
7063,Ronny Turiaf,28,64,21,1141,103,163,0.632,0,0,,103,163,0.632,0.632,61,98,0.622,64,143,207,92,35,73,41,160,267,NYK,2011
7064,Carmelo Anthony,26,27,27,977,247,536,0.461,53,125,0.424,194,411,0.472,0.510,164,188,0.872,41,140,181,81,25,15,64,90,711,NYK,2011
7065,Henry Walker,23,61,1,784,104,236,0.441,59,153,0.386,45,83,0.542,0.566,31,44,0.705,16,106,122,34,21,6,37,81,298,NYK,2011
7066,Chauncey Billups,34,21,21,664,104,258,0.403,41,125,0.328,63,133,0.474,0.483,119,132,0.902,13,52,65,116,19,2,48,52,368,NYK,2011
7067,Jared Jeffries,29,24,9,463,19,50,0.380,1,3,0.333,18,47,0.383,0.390,8,19,0.421,42,39,81,25,24,14,17,54,47,NYK,2011
7068,Timofey Mozgov,24,34,14,458,52,112,0.464,0,0,,52,112,0.464,0.464,31,44,0.705,41,63,104,15,14,23,32,76,135,NYK,2011
7069,Roger Mason,30,26,0,319,26,77,0.338,16,44,0.364,10,33,0.303,0.442,7,10,0.700,5,38,43,20,6,2,6,25,75,NYK,2011
7070,Anthony Carter,35,19,0,310,35,76,0.461,8,28,0.286,27,48,0.563,0.513,6,6,1.000,7,32,39,43,18,5,25,30,84,NYK,2011
7071,Shelden Williams,27,17,6,198,21,39,0.538,0,0,,21,39,0.538,0.538,24,29,0.828,19,31,50,13,5,4,6,34,66,NYK,2011
7072,Anthony Randolph,21,17,0,127,14,45,0.311,1,4,0.250,13,41,0.317,0.322,6,12,0.500,11,29,40,7,4,8,10,15,35,NYK,2011
7073,Derrick Brown,23,8,0,88,12,18,0.667,3,4,0.750,9,14,0.643,0.750,7,13,0.538,9,6,15,4,4,2,7,11,34,NYK,2011
7074,Andy Rautins,24,5,0,24,3,7,0.429,1,4,0.250,2,3,0.667,0.500,1,2,0.500,0,1,1,3,1,0,7,0,8,NYK,2011
7075,Renaldo Balkman,26,3,0,18,1,4,0.250,1,2,0.500,0,2,0.000,0.375,0,0,,1,2,3,0,1,0,1,4,3,NYK,2011
7076,Brook Lopez,22,82,82,2889,644,1309,0.492,0,1,0.000,644,1308,0.492,0.492,385,489,0.787,197,291,488,129,47,120,176,240,1673,NJN,2011
7077,Travis Outlaw,26,82,55,2358,274,731,0.375,76,252,0.302,198,479,0.413,0.427,132,171,0.772,54,271,325,84,34,36,71,148,756,NJN,2011
7078,Kris Humphries,25,74,44,2061,307,583,0.527,0,1,0.000,307,582,0.527,0.527,127,191,0.665,225,546,771,84,33,80,103,168,741,NJN,2011
7079,Anthony Morrow,25,58,47,1856,279,620,0.450,110,260,0.423,169,360,0.469,0.539,96,107,0.897,37,135,172,68,19,7,54,135,764,NJN,2011
7080,Jordan Farmar,24,73,18,1796,255,651,0.392,109,304,0.359,146,347,0.421,0.475,82,100,0.820,24,149,173,368,62,6,139,128,701,NJN,2011
7081,Devin Harris,27,54,54,1724,260,612,0.425,33,110,0.300,227,502,0.452,0.452,258,307,0.840,11,118,129,411,57,5,158,130,811,NJN,2011
7082,Sasha Vujačić,26,56,17,1594,231,572,0.404,94,255,0.369,137,317,0.432,0.486,80,94,0.851,29,153,182,127,53,5,61,129,636,NJN,2011
7083,Derrick Favors,19,56,23,1091,141,276,0.511,0,0,,141,276,0.511,0.511,71,116,0.612,126,171,297,21,18,41,56,183,353,NJN,2011
7084,Stephen Graham,28,59,28,959,81,200,0.405,5,21,0.238,76,179,0.425,0.418,31,38,0.816,17,106,123,40,14,1,38,106,198,NJN,2011
7085,Johan Petro,25,77,1,893,129,290,0.445,0,4,0.000,129,286,0.451,0.445,15,28,0.536,62,150,212,44,34,34,46,178,273,NJN,2011
7086,Deron Williams,26,12,12,456,59,169,0.349,16,59,0.271,43,110,0.391,0.396,46,58,0.793,8,47,55,153,15,3,43,38,180,NJN,2011
7087,Ben Uzoh,22,42,0,438,61,144,0.424,3,8,0.375,58,136,0.426,0.434,33,56,0.589,30,31,61,69,13,8,25,29,158,NJN,2011
7088,Damion James,23,25,9,403,46,103,0.447,0,3,0.000,46,100,0.460,0.447,18,28,0.643,17,68,85,20,16,12,25,36,110,NJN,2011
7089,Quinton Ross,29,36,4,353,26,59,0.441,0,3,0.000,26,56,0.464,0.441,5,14,0.357,10,20,30,10,3,6,7,40,57,NJN,2011
7090,Troy Murphy,30,18,4,288,26,76,0.342,4,23,0.174,22,53,0.415,0.368,9,17,0.529,11,64,75,17,7,2,13,28,65,NJN,2011
7091,Terrence Williams,23,10,0,206,29,73,0.397,4,12,0.333,25,61,0.410,0.425,5,10,0.500,3,33,36,31,5,0,25,21,67,NJN,2011
7092,Brandan Wright,23,16,1,184,22,54,0.407,0,0,,22,54,0.407,0.407,14,17,0.824,17,31,48,7,8,7,4,15,58,NJN,2011
7093,Dan Gadzuric,32,14,5,166,17,41,0.415,0,0,,17,41,0.415,0.415,5,13,0.385,18,31,49,3,3,11,8,28,39,NJN,2011
7094,Sundiata Gaines,24,10,0,146,20,48,0.417,4,17,0.235,16,31,0.516,0.458,11,20,0.550,10,14,24,25,9,0,13,11,55,NJN,2011
7095,Mario West,26,6,3,116,9,21,0.429,1,4,0.250,8,17,0.471,0.452,3,5,0.600,2,9,11,10,7,0,2,13,22,NJN,2011
7096,Joe Smith,35,4,3,25,1,4,0.250,0,0,,1,4,0.250,0.250,0,0,,1,2,3,1,0,0,2,3,2,NJN,2011
7097,Orien Greene,28,3,0,5,1,2,0.500,0,0,,1,2,0.500,0.500,1,2,0.500,0,0,0,1,1,0,0,0,3,NJN,2011
7098,DeMar DeRozan,21,82,82,2851,539,1154,0.467,5,52,0.096,534,1102,0.485,0.469,327,402,0.813,75,240,315,148,85,31,144,217,1410,TOR,2011
7099,Andrea Bargnani,25,66,66,2353,525,1173,0.448,77,223,0.345,448,950,0.472,0.480,287,350,0.820,74,269,343,119,34,46,152,160,1414,TOR,2011
6610,Brian Skinner,35,1,0,4,0,1,0.000,0,0,,0,1,0.000,0.000,0,0,,0,0,0,0,0,0,0,1,0,MEM,2012
6485,Luis Scola,31,66,66,2067,436,888,0.491,0,3,0.000,436,885,0.493,0.491,153,198,0.773,122,306,428,140,35,24,153,214,1025,HOU,2012
6486,Chandler Parsons,23,63,57,1804,248,549,0.452,60,178,0.337,188,371,0.507,0.506,43,78,0.551,90,210,300,134,73,29,81,142,599,HOU,2012
6487,Courtney Lee,26,58,26,1757,251,580,0.433,87,217,0.401,164,363,0.452,0.508,71,86,0.826,26,133,159,88,68,22,64,106,660,HOU,2012
6488,Goran Dragić,25,66,28,1752,277,600,0.462,68,202,0.337,209,398,0.525,0.518,153,190,0.805,53,115,168,351,85,10,157,166,775,HOU,2012
6489,Kyle Lowry,25,47,38,1510,210,513,0.409,79,211,0.374,131,302,0.434,0.486,171,198,0.864,37,176,213,310,73,14,130,133,670,HOU,2012
6490,Patrick Patterson,22,64,1,1483,225,511,0.440,0,3,0.000,225,508,0.443,0.440,40,57,0.702,112,174,286,53,27,36,49,113,490,HOU,2012
6491,Samuel Dalembert,30,65,45,1446,200,395,0.506,0,1,0.000,200,394,0.508,0.506,90,113,0.796,158,298,456,33,37,111,82,162,490,HOU,2012
6492,Chase Budinger,23,58,9,1298,208,471,0.442,88,219,0.402,120,252,0.476,0.535,54,70,0.771,38,179,217,74,29,7,55,65,558,HOU,2012
6493,Kevin Martin,28,40,40,1264,222,537,0.413,78,225,0.347,144,312,0.462,0.486,160,179,0.894,13,93,106,110,28,3,70,70,682,HOU,2012
6494,Jordan Hill,24,32,7,469,68,135,0.504,0,3,0.000,68,132,0.515,0.504,25,39,0.641,47,108,155,14,9,21,24,60,161,HOU,2012
6495,Marcus Camby,37,19,13,458,61,126,0.484,2,5,0.400,59,121,0.488,0.492,11,26,0.423,52,124,176,32,17,29,10,38,135,HOU,2012
6496,Terrence Williams,24,12,0,181,20,57,0.351,8,19,0.421,12,38,0.316,0.421,6,12,0.500,2,26,28,10,4,1,10,16,54,HOU,2012
6497,Jonny Flynn,22,11,0,135,12,41,0.293,2,9,0.222,10,32,0.313,0.317,11,14,0.786,1,7,8,28,3,1,9,8,37,HOU,2012
6498,Marcus Morris,22,17,0,126,16,54,0.296,2,17,0.118,14,37,0.378,0.315,6,8,0.750,5,11,16,3,2,2,4,12,40,HOU,2012
6499,Earl Boykins,35,8,0,111,12,36,0.333,2,9,0.222,10,27,0.370,0.361,13,15,0.867,0,11,11,17,1,0,7,5,39,HOU,2012
6500,Greg Smith,21,8,0,69,7,11,0.636,0,0,,7,11,0.636,0.636,0,0,,5,15,20,1,2,5,1,17,14,HOU,2012
6501,Jeff Adrien,25,8,0,63,7,16,0.438,0,0,,7,16,0.438,0.438,7,12,0.583,5,17,22,1,0,2,2,13,21,HOU,2012
6502,Courtney Fortson,23,6,0,49,6,20,0.300,2,9,0.222,4,11,0.364,0.350,4,6,0.667,2,5,7,5,3,0,5,2,18,HOU,2012
6503,Hasheem Thabeet,24,5,0,23,3,3,1.000,0,0,,3,3,1.000,1.000,0,0,,1,6,7,0,0,2,0,5,6,HOU,2012
6504,Andre Iguodala,28,62,62,2209,287,632,0.454,76,193,0.394,211,439,0.481,0.514,121,196,0.617,56,325,381,339,107,30,115,92,771,PHI,2012
6505,Jrue Holiday,21,65,65,2196,360,834,0.432,65,171,0.380,295,663,0.445,0.471,94,120,0.783,57,155,212,290,103,18,135,137,879,PHI,2012
6506,Thaddeus Young,23,63,1,1755,348,687,0.507,1,4,0.250,347,683,0.508,0.507,111,144,0.771,137,188,325,74,64,41,55,127,808,PHI,2012
6507,Elton Brand,32,60,60,1732,287,581,0.494,0,1,0.000,287,580,0.495,0.494,85,116,0.733,145,284,429,97,58,97,65,176,659,PHI,2012
6508,Evan Turner,23,65,20,1713,263,590,0.446,11,49,0.224,252,541,0.466,0.455,73,108,0.676,27,349,376,180,40,20,105,117,610,PHI,2012
6509,Lou Williams,25,64,0,1682,318,782,0.407,83,229,0.362,235,553,0.425,0.460,237,292,0.812,30,125,155,221,53,18,71,90,956,PHI,2012
6510,Jodie Meeks,24,66,50,1644,191,467,0.409,97,266,0.365,94,201,0.468,0.513,77,85,0.906,17,144,161,54,40,3,29,82,556,PHI,2012
6511,Spencer Hawes,23,37,29,920,156,319,0.489,3,12,0.250,153,307,0.498,0.494,40,55,0.727,78,192,270,98,16,48,55,100,355,PHI,2012
6512,Nikola Vučević,21,51,15,812,131,291,0.450,3,8,0.375,128,283,0.452,0.455,18,34,0.529,88,158,246,31,20,34,33,111,283,PHI,2012
6513,Lavoy Allen,22,41,15,624,79,167,0.473,0,0,,79,167,0.473,0.473,11,14,0.786,47,124,171,34,13,18,20,73,169,PHI,2012
6514,Tony Battie,35,27,11,295,19,51,0.373,0,1,0.000,19,50,0.380,0.373,4,4,1.000,8,59,67,16,4,6,4,26,42,PHI,2012
6515,Sam Young,26,14,0,135,13,44,0.295,5,8,0.625,8,36,0.222,0.352,9,14,0.643,6,15,21,6,6,4,7,11,40,PHI,2012
6516,Craig Brackins,24,14,1,88,9,33,0.273,3,9,0.333,6,24,0.250,0.318,1,2,0.500,5,10,15,8,0,1,4,6,22,PHI,2012
6517,Andrés Nocioni,32,11,1,56,5,20,0.250,1,6,0.167,4,14,0.286,0.275,6,11,0.545,1,13,14,1,1,1,5,4,17,PHI,2012
6518,Xavier Silas,24,2,0,39,4,15,0.267,1,6,0.167,3,9,0.333,0.300,2,3,0.667,2,2,4,3,0,0,3,5,11,PHI,2012
6519,Francisco Elson,35,5,0,16,1,3,0.333,0,0,,1,3,0.333,0.333,0,0,,0,1,1,1,1,1,1,0,2,PHI,2012
6520,Paul Pierce,34,61,61,2075,394,890,0.443,100,273,0.366,294,617,0.476,0.499,293,344,0.852,37,280,317,274,70,26,173,147,1181,BOS,2012
6521,Rajon Rondo,25,53,53,1957,256,572,0.448,10,42,0.238,246,530,0.464,0.456,108,181,0.597,62,195,257,620,95,3,193,99,630,BOS,2012
6522,Brandon Bass,26,59,39,1868,303,632,0.479,0,0,,303,632,0.479,0.479,132,163,0.810,95,270,365,55,34,54,65,135,738,BOS,2012
6523,Kevin Garnett,35,60,60,1864,391,777,0.503,3,9,0.333,388,768,0.505,0.505,162,189,0.857,66,428,494,175,56,61,107,141,947,BOS,2012
6524,Ray Allen,36,46,42,1565,226,493,0.458,106,234,0.453,120,259,0.463,0.566,97,106,0.915,14,128,142,109,49,8,68,83,655,BOS,2012
6525,Avery Bradley,21,64,28,1368,200,402,0.498,22,54,0.407,178,348,0.511,0.525,62,78,0.795,34,81,115,87,43,12,75,109,484,BOS,2012
6526,Mickaël Piétrus,29,42,6,921,104,270,0.385,61,182,0.335,43,88,0.489,0.498,20,31,0.645,18,112,130,25,21,10,33,81,289,BOS,2012
6527,Greg Stiemsma,26,55,3,766,66,121,0.545,0,0,,66,121,0.545,0.545,29,41,0.707,48,129,177,28,37,85,33,144,161,BOS,2012
6528,Keyon Dooling,31,46,2,662,66,163,0.405,27,81,0.333,39,82,0.476,0.488,23,31,0.742,3,36,39,51,13,2,34,57,182,BOS,2012
6529,Jermaine O'Neal,33,25,24,570,52,120,0.433,0,0,,52,120,0.433,0.433,21,31,0.677,37,98,135,10,8,43,21,80,125,BOS,2012
6530,Sasha Pavlović,28,45,7,527,50,128,0.391,17,58,0.293,33,70,0.471,0.457,3,8,0.375,4,68,72,18,20,15,20,54,120,BOS,2012
6531,Marquis Daniels,31,38,0,484,52,143,0.364,0,10,0.000,52,133,0.391,0.364,17,23,0.739,16,50,66,47,21,9,28,36,121,BOS,2012
6532,Chris Wilcox,29,28,4,481,64,107,0.598,0,0,,64,107,0.598,0.598,24,39,0.615,38,84,122,12,11,9,30,64,152,BOS,2012
6533,E'Twaun Moore,22,38,0,331,43,113,0.381,17,45,0.378,26,68,0.382,0.456,7,7,1.000,4,29,33,34,11,3,21,33,110,BOS,2012
6534,JaJuan Johnson,22,36,0,298,54,121,0.446,0,0,,54,121,0.446,0.446,6,9,0.667,20,38,58,6,5,14,14,25,114,BOS,2012
6535,Ryan Hollins,27,15,1,160,18,28,0.643,0,0,,18,28,0.643,0.643,6,20,0.300,9,17,26,3,1,5,11,23,42,BOS,2012
6536,Sean Williams,25,3,0,42,2,6,0.333,0,0,,2,6,0.333,0.333,7,7,1.000,4,8,12,3,3,3,3,4,11,BOS,2012
6537,Tyson Chandler,29,62,62,2061,241,355,0.679,0,2,0.000,241,353,0.683,0.679,217,315,0.689,212,400,612,56,56,89,102,186,699,NYK,2012
6538,Landry Fields,23,66,62,1894,236,513,0.460,31,121,0.256,205,392,0.523,0.490,77,137,0.562,59,219,278,169,79,17,102,99,580,NYK,2012
6539,Carmelo Anthony,27,55,55,1876,441,1025,0.430,68,203,0.335,373,822,0.454,0.463,295,367,0.804,88,256,344,200,62,24,144,156,1245,NYK,2012
6540,Iman Shumpert,21,59,35,1705,214,534,0.401,48,157,0.306,166,377,0.440,0.446,87,109,0.798,42,144,186,164,101,8,111,173,563,NYK,2012
6541,Amar'e Stoudemire,29,47,47,1543,316,654,0.483,5,21,0.238,311,633,0.491,0.487,186,243,0.765,106,261,367,52,38,45,112,138,823,NYK,2012
6542,Steve Novak,28,54,0,1020,161,337,0.478,133,282,0.472,28,55,0.509,0.675,22,26,0.846,9,95,104,12,16,9,21,59,477,NYK,2012
6543,J.R. Smith,26,35,1,967,165,405,0.407,67,193,0.347,98,212,0.462,0.490,39,55,0.709,29,107,136,84,54,6,46,87,436,NYK,2012
6544,Jeremy Lin,23,35,25,940,171,383,0.446,24,75,0.320,147,308,0.477,0.478,146,183,0.798,18,89,107,216,55,9,126,78,512,NYK,2012
6545,Jared Jeffries,30,39,4,729,59,144,0.410,3,16,0.188,56,128,0.438,0.420,49,72,0.681,69,83,152,26,29,25,29,89,170,NYK,2012
6546,Toney Douglas,25,38,9,656,94,290,0.324,27,117,0.231,67,173,0.387,0.371,22,26,0.846,16,56,72,77,29,1,56,55,237,NYK,2012
6547,Henry Walker,24,32,8,620,68,171,0.398,36,113,0.319,32,58,0.552,0.503,17,20,0.850,9,71,80,37,19,7,35,84,189,NYK,2012
6548,Baron Davis,32,29,14,595,68,184,0.370,26,85,0.306,42,99,0.424,0.440,16,24,0.667,13,43,56,135,34,3,76,61,178,NYK,2012
6549,Mike Bibby,33,39,4,557,35,124,0.282,27,85,0.318,8,39,0.205,0.391,6,8,0.750,5,54,59,80,21,3,20,45,103,NYK,2012
6550,Josh Harrellson,22,37,4,540,63,149,0.423,20,59,0.339,43,90,0.478,0.490,16,26,0.615,47,97,144,11,23,20,20,48,162,NYK,2012
6551,Renaldo Balkman,27,14,0,115,16,32,0.500,2,9,0.222,14,23,0.609,0.531,8,11,0.727,6,20,26,5,4,3,6,14,42,NYK,2012
6552,Jerome Jordan,25,21,0,108,17,33,0.515,0,0,,17,33,0.515,0.515,8,10,0.800,14,13,27,4,1,6,2,15,42,NYK,2012
6553,Dan Gadzuric,33,2,0,13,0,2,0.000,0,0,,0,2,0.000,0.000,0,2,0.000,1,4,5,0,1,1,1,4,0,NYK,2012
6554,Kris Humphries,26,62,62,2162,323,671,0.481,0,0,,323,671,0.481,0.481,209,278,0.752,233,448,681,90,50,74,119,173,855,NJN,2012
6555,Deron Williams,27,55,55,1999,391,961,0.407,115,342,0.336,276,619,0.446,0.467,257,305,0.843,23,160,183,481,67,20,219,121,1154,NJN,2012
6556,MarShon Brooks,23,56,47,1648,274,640,0.428,47,150,0.313,227,490,0.463,0.465,113,148,0.764,70,130,200,131,52,15,118,116,708,NJN,2012
6557,Anthony Morrow,26,62,18,1636,272,658,0.413,106,286,0.371,166,372,0.446,0.494,97,104,0.933,31,96,127,61,46,9,70,86,747,NJN,2012
6558,Shelden Williams,28,58,35,1276,96,201,0.478,0,0,,96,201,0.478,0.478,76,104,0.731,141,209,350,35,47,39,66,149,268,NJN,2012
6559,DeShawn Stevenson,30,51,30,960,49,172,0.285,41,145,0.283,8,27,0.296,0.404,9,16,0.563,7,94,101,41,19,4,19,59,148,NJN,2012
6560,Johan Petro,26,59,10,920,109,260,0.419,1,1,1.000,108,259,0.417,0.421,31,37,0.838,68,156,224,45,21,23,38,122,250,NJN,2012
6561,Jordan Farmar,25,39,5,831,147,315,0.467,55,125,0.440,92,190,0.484,0.554,57,63,0.905,7,54,61,129,24,2,68,49,406,NJN,2012
6562,Sundiata Gaines,25,57,12,793,102,271,0.376,28,82,0.341,74,189,0.392,0.428,59,96,0.615,27,81,108,126,55,2,52,58,291,NJN,2012
6563,Gerald Green,26,31,2,781,154,320,0.481,43,110,0.391,111,210,0.529,0.548,49,65,0.754,15,93,108,34,28,17,55,80,400,NJN,2012
6564,Jordan Williams,21,43,5,635,77,152,0.507,0,0,,77,152,0.507,0.507,43,66,0.652,66,90,156,11,21,15,23,61,197,NJN,2012
6565,Gerald Wallace,29,16,16,573,84,202,0.416,20,52,0.385,64,150,0.427,0.465,55,64,0.859,24,85,109,49,23,11,27,38,243,NJN,2012
6566,Shawne Williams,25,25,6,514,42,147,0.286,21,87,0.241,21,60,0.350,0.357,8,11,0.727,20,48,68,16,10,11,13,44,113,NJN,2012
6567,Mehmet Okur,32,17,14,454,52,139,0.374,23,72,0.319,29,67,0.433,0.457,3,5,0.600,22,59,81,30,9,5,25,45,130,NJN,2012
6568,Damion James,24,7,7,170,13,35,0.371,0,1,0.000,13,34,0.382,0.371,8,12,0.667,7,26,33,3,7,7,12,17,34,NJN,2012
6569,Brook Lopez,23,5,5,136,38,77,0.494,0,0,,38,77,0.494,0.494,20,32,0.625,8,10,18,6,1,4,6,8,96,NJN,2012
6570,Armon Johnson,22,8,0,119,19,42,0.452,1,3,0.333,18,39,0.462,0.464,6,6,1.000,1,11,12,11,4,0,5,9,45,NJN,2012
6571,Keith Bogans,31,5,1,94,8,21,0.381,3,12,0.250,5,9,0.556,0.452,2,5,0.400,5,6,11,3,2,0,3,15,21,NJN,2012
6572,Larry Owens,29,7,0,75,4,11,0.364,2,5,0.400,2,6,0.333,0.455,3,4,0.750,2,11,13,4,0,1,2,10,13,NJN,2012
6573,Jerry Smith,24,5,0,46,3,14,0.214,1,6,0.167,2,8,0.250,0.250,0,0,,2,5,7,4,5,0,0,5,7,NJN,2012
6574,Andre Emmett,29,6,0,45,4,7,0.571,0,1,0.000,4,6,0.667,0.571,5,8,0.625,2,4,6,1,2,1,2,2,13,NJN,2012
6575,Dennis Horner,23,8,0,22,1,4,0.250,0,1,0.000,1,3,0.333,0.250,3,4,0.750,2,3,5,0,0,0,1,1,5,NJN,2012
6576,DeMar DeRozan,22,63,63,2206,381,903,0.422,24,92,0.261,357,811,0.440,0.435,268,331,0.810,40,171,211,128,48,17,123,162,1054,TOR,2012
6577,José Calderón,30,53,53,1799,218,477,0.457,59,159,0.371,159,318,0.500,0.519,60,68,0.882,19,141,160,468,47,3,104,94,555,TOR,2012
6578,James Johnson,24,62,40,1561,233,518,0.450,19,60,0.317,214,458,0.467,0.468,81,115,0.704,74,218,292,122,71,84,101,177,566,TOR,2012
6579,Amir Johnson,24,64,43,1553,196,340,0.576,2,5,0.400,194,335,0.579,0.579,58,84,0.690,149,259,408,79,33,69,94,209,452,TOR,2012
6580,Ed Davis,22,66,9,1534,172,335,0.513,0,1,0.000,172,334,0.515,0.513,71,106,0.670,134,304,438,60,40,63,67,156,415,TOR,2012
6581,Linas Kleiza,27,49,3,1057,165,410,0.402,62,179,0.346,103,231,0.446,0.478,81,100,0.810,42,157,199,46,23,4,64,119,473,TOR,2012
6582,Andrea Bargnani,26,31,31,1032,209,484,0.432,34,115,0.296,175,369,0.474,0.467,151,173,0.873,24,148,172,61,18,15,69,52,603,TOR,2012
6583,Leandro Barbosa,29,42,0,946,198,454,0.436,40,111,0.360,158,343,0.461,0.480,76,91,0.835,21,58,79,63,36,7,68,101,512,TOR,2012
6429,Jeremy Tyler,21,1,0,5,0,0,,0,0,,0,0,,,0,0,,0,3,3,0,0,0,0,0,0,ATL,2013
5962,James Harden,23,78,78,2985,585,1337,0.438,179,486,0.368,406,851,0.477,0.504,674,792,0.851,62,317,379,455,142,38,295,178,2023,HOU,2013
5963,Chandler Parsons,24,76,76,2758,456,939,0.486,152,395,0.385,304,544,0.559,0.567,113,155,0.729,79,325,404,269,75,32,147,148,1177,HOU,2013
5964,Jeremy Lin,24,82,82,2640,396,897,0.441,87,257,0.339,309,640,0.483,0.490,216,275,0.785,32,215,247,497,134,29,236,205,1095,HOU,2013
5965,Ömer Aşık,26,82,82,2464,332,614,0.541,0,1,0.000,332,613,0.542,0.541,168,299,0.562,275,681,956,75,46,87,173,223,832,HOU,2013
5966,Carlos Delfino,30,67,5,1689,251,620,0.405,158,421,0.375,93,199,0.467,0.532,48,56,0.857,18,202,220,135,68,9,72,114,708,HOU,2013
5967,Patrick Patterson,23,47,38,1219,236,455,0.519,35,96,0.365,201,359,0.560,0.557,37,49,0.755,73,148,221,51,18,27,42,90,544,HOU,2013
5968,Marcus Morris,23,54,17,1154,171,400,0.428,74,194,0.381,97,206,0.471,0.520,49,75,0.653,63,156,219,47,27,16,53,120,465,HOU,2013
5969,Greg Smith,22,70,10,1110,170,274,0.620,0,1,0.000,170,273,0.623,0.620,81,130,0.623,111,210,321,25,18,40,41,175,421,HOU,2013
5970,Toney Douglas,26,49,0,913,139,352,0.395,61,162,0.377,78,190,0.411,0.482,60,68,0.882,23,67,90,93,40,2,56,103,399,HOU,2013
5971,Patrick Beverley,24,41,0,713,79,189,0.418,36,96,0.375,43,93,0.462,0.513,34,41,0.829,45,64,109,117,37,21,44,83,228,HOU,2013
5972,Donatas Motiejūnas,22,44,14,538,97,213,0.455,24,83,0.289,73,130,0.562,0.512,32,51,0.627,36,57,93,31,7,10,37,73,250,HOU,2013
5973,Francisco García,31,18,5,319,41,95,0.432,27,70,0.386,14,25,0.560,0.574,6,7,0.857,1,22,23,20,14,7,12,22,115,HOU,2013
5974,James Anderson,23,29,2,307,41,101,0.406,16,49,0.327,25,52,0.481,0.485,17,19,0.895,15,43,58,33,12,3,18,18,115,HOU,2013
5975,Terrence Jones,21,19,0,276,43,94,0.457,5,19,0.263,38,75,0.507,0.484,13,17,0.765,28,37,65,15,12,19,13,21,104,HOU,2013
5976,Thomas Robinson,21,19,0,247,35,78,0.449,0,1,0.000,35,77,0.455,0.449,16,38,0.421,30,47,77,10,16,5,23,29,86,HOU,2013
5977,Cole Aldrich,24,30,0,213,23,43,0.535,0,0,,23,43,0.535,0.535,4,9,0.444,12,45,57,6,3,9,14,41,50,HOU,2013
5978,Daequan Cook,25,16,1,165,21,59,0.356,11,30,0.367,10,29,0.345,0.449,2,3,0.667,5,13,18,10,6,2,6,13,55,HOU,2013
5979,Aaron Brooks,28,7,0,38,4,13,0.308,2,7,0.286,2,6,0.333,0.385,0,0,,1,1,2,6,1,3,4,5,10,HOU,2013
5980,Scott Machado,22,6,0,21,3,6,0.500,0,1,0.000,3,5,0.600,0.500,2,2,1.000,0,1,1,6,2,0,8,0,8,HOU,2013
5981,Tim Ohlbrecht,24,3,0,12,1,3,0.333,0,0,,1,3,0.333,0.333,1,1,1.000,0,1,1,1,1,0,4,1,3,HOU,2013
5982,Jrue Holiday,22,78,78,2926,555,1288,0.431,91,247,0.368,464,1041,0.446,0.466,182,242,0.752,89,240,329,625,123,32,292,170,1383,PHI,2013
5983,Evan Turner,24,82,82,2892,441,1053,0.419,58,159,0.365,383,894,0.428,0.446,154,208,0.740,56,461,517,354,71,17,187,197,1094,PHI,2013
5984,Thaddeus Young,24,76,76,2629,509,958,0.531,1,8,0.125,508,950,0.535,0.532,108,188,0.574,182,389,571,125,133,55,90,191,1127,PHI,2013
5985,Spencer Hawes,24,82,40,2233,376,811,0.464,31,87,0.356,345,724,0.477,0.483,122,157,0.777,173,417,590,183,24,113,131,233,905,PHI,2013
5986,Dorell Wright,27,79,8,1783,237,599,0.396,135,361,0.374,102,238,0.429,0.508,120,141,0.851,42,260,302,150,62,35,64,98,729,PHI,2013
5987,Lavoy Allen,23,79,37,1669,206,454,0.454,0,1,0.000,206,453,0.455,0.454,43,60,0.717,159,236,395,73,24,55,55,180,455,PHI,2013
5988,Nick Young,27,59,17,1411,224,542,0.413,75,210,0.357,149,332,0.449,0.482,105,128,0.820,24,106,130,84,36,14,50,84,628,PHI,2013
5989,Damien Wilkins,33,61,21,1095,145,316,0.459,17,51,0.333,128,265,0.483,0.486,81,109,0.743,32,73,105,91,37,18,49,98,388,PHI,2013
5990,Jason Richardson,32,33,33,936,135,336,0.402,57,167,0.341,78,169,0.462,0.487,20,33,0.606,19,108,127,51,40,15,26,57,347,PHI,2013
5991,Royal Ivey,31,53,5,698,62,144,0.431,37,88,0.420,25,56,0.446,0.559,9,16,0.563,16,41,57,32,23,3,20,73,170,PHI,2013
5992,Arnett Moultrie,22,47,0,542,78,134,0.582,0,0,,78,134,0.582,0.582,18,28,0.643,76,69,145,10,17,10,19,43,174,PHI,2013
5993,Kwame Brown,30,22,11,269,17,37,0.459,0,0,,17,37,0.459,0.459,7,19,0.368,23,51,74,9,6,10,8,37,41,PHI,2013
5994,Jeremy Pargo,26,14,0,208,24,63,0.381,7,17,0.412,17,46,0.370,0.437,14,21,0.667,1,16,17,28,1,0,13,14,69,PHI,2013
5995,Maalik Wayns,21,21,1,165,19,72,0.264,5,25,0.200,14,47,0.298,0.299,13,15,0.867,1,4,5,20,3,0,13,18,56,PHI,2013
5996,Charles Jenkins,23,12,1,150,14,38,0.368,0,0,,14,38,0.368,0.368,2,4,0.500,3,8,11,16,6,1,2,4,30,PHI,2013
5997,Justin Holiday,23,9,0,142,16,48,0.333,4,16,0.250,12,32,0.375,0.375,6,8,0.750,0,14,14,15,3,6,9,7,42,PHI,2013
5998,Shelvin Mack,22,4,0,7,1,2,0.500,0,1,0.000,1,1,1.000,0.500,0,0,,0,0,0,1,0,0,2,1,2,PHI,2013
5999,Paul Pierce,35,77,77,2575,476,1092,0.436,145,382,0.380,331,710,0.466,0.502,333,423,0.787,45,442,487,370,84,30,214,210,1430,BOS,2013
6000,Jeff Green,26,81,17,2252,376,806,0.467,70,182,0.385,306,624,0.490,0.510,214,265,0.808,55,263,318,128,56,68,132,175,1036,BOS,2013
6001,Brandon Bass,27,81,69,2239,286,589,0.486,0,2,0.000,286,587,0.487,0.486,129,150,0.860,129,296,425,84,44,64,80,188,701,BOS,2013
6002,Jason Terry,35,79,24,2124,281,648,0.434,123,331,0.372,158,317,0.498,0.529,114,131,0.870,19,140,159,198,66,11,102,110,799,BOS,2013
6003,Kevin Garnett,36,68,68,2022,422,850,0.496,2,16,0.125,420,834,0.504,0.498,158,201,0.786,75,455,530,159,78,62,110,154,1004,BOS,2013
6004,Courtney Lee,27,78,39,1941,246,530,0.464,58,156,0.372,188,374,0.503,0.519,62,72,0.861,31,159,190,143,89,21,84,139,612,BOS,2013
6005,Avery Bradley,22,50,50,1435,192,478,0.402,40,126,0.317,152,352,0.432,0.444,37,49,0.755,30,81,111,104,64,19,72,129,461,BOS,2013
6006,Rajon Rondo,26,38,38,1423,225,465,0.484,12,50,0.240,213,415,0.513,0.497,60,93,0.645,43,169,212,420,70,9,148,96,522,BOS,2013
6007,Jared Sullinger,20,45,5,892,111,225,0.493,1,5,0.200,110,220,0.500,0.496,47,63,0.746,92,172,264,35,22,22,29,154,270,BOS,2013
6008,Chris Wilcox,30,61,7,830,110,153,0.719,0,1,0.000,110,152,0.724,0.719,39,58,0.672,55,125,180,22,32,28,34,125,259,BOS,2013
6009,Jordan Crawford,24,27,2,582,90,217,0.415,24,75,0.320,66,142,0.465,0.470,42,53,0.792,13,61,74,68,12,2,44,45,246,BOS,2013
6010,Leandro Barbosa,30,41,2,513,83,193,0.430,18,47,0.383,65,146,0.445,0.477,31,41,0.756,8,38,46,58,17,6,21,51,215,BOS,2013
6011,Jason Collins,34,32,7,330,8,23,0.348,0,0,,8,23,0.348,0.348,21,30,0.700,21,31,52,6,10,6,16,74,37,BOS,2013
6012,Terrence Williams,25,24,0,318,48,97,0.495,5,15,0.333,43,82,0.524,0.521,9,21,0.429,4,40,44,38,11,2,22,13,110,BOS,2013
6013,Shavlik Randolph,29,16,0,198,28,48,0.583,0,0,,28,48,0.583,0.583,11,27,0.407,28,42,70,4,8,7,10,38,67,BOS,2013
6014,D.J. White,26,12,0,86,12,23,0.522,0,0,,12,23,0.522,0.522,5,9,0.556,4,9,13,4,1,6,2,5,29,BOS,2013
6015,Fab Melo,22,6,0,36,3,6,0.500,0,0,,3,6,0.500,0.500,1,4,0.250,0,3,3,0,2,2,1,7,7,BOS,2013
6016,Kris Joseph,24,6,0,24,2,11,0.182,0,2,0.000,2,9,0.222,0.182,3,4,0.750,1,4,5,1,0,0,2,2,7,BOS,2013
6017,Jarvis Varnado,24,5,0,18,2,4,0.500,0,0,,2,4,0.500,0.500,2,4,0.500,1,2,3,1,1,0,1,1,6,BOS,2013
6018,Darko Miličić,27,1,0,5,0,1,0.000,0,0,,0,1,0.000,0.000,0,0,,0,1,1,0,0,0,2,1,0,BOS,2013
6019,J.R. Smith,27,80,0,2678,527,1249,0.422,155,436,0.356,372,813,0.458,0.484,237,311,0.762,64,361,425,218,100,24,134,226,1446,NYK,2013
6020,Carmelo Anthony,28,67,67,2482,669,1489,0.449,157,414,0.379,512,1075,0.476,0.502,425,512,0.830,134,326,460,171,52,32,175,205,1920,NYK,2013
6021,Raymond Felton,28,68,68,2313,377,882,0.427,93,258,0.360,284,624,0.455,0.480,101,128,0.789,51,143,194,372,94,14,155,130,948,NYK,2013
6022,Tyson Chandler,30,66,66,2164,255,400,0.638,0,0,,255,400,0.638,0.638,179,258,0.694,269,434,703,62,42,75,87,188,689,NYK,2013
6023,Jason Kidd,39,76,48,2043,152,409,0.372,114,325,0.351,38,84,0.452,0.511,40,48,0.833,50,273,323,249,125,25,76,125,458,NYK,2013
6024,Steve Novak,29,81,1,1641,178,430,0.414,149,351,0.425,29,79,0.367,0.587,30,33,0.909,17,135,152,35,28,8,12,97,535,NYK,2013
6025,Pablo Prigioni,35,78,18,1263,100,220,0.455,53,134,0.396,47,86,0.547,0.575,22,25,0.880,41,102,143,236,69,2,86,127,275,NYK,2013
6026,Iman Shumpert,22,45,45,996,109,275,0.396,51,127,0.402,58,148,0.392,0.489,36,47,0.766,31,105,136,75,43,7,37,99,305,NYK,2013
6027,Chris Copeland,28,56,13,862,182,380,0.479,59,140,0.421,123,240,0.513,0.557,63,83,0.759,34,85,119,27,16,12,50,104,486,NYK,2013
6028,Ronnie Brewer,27,46,34,711,64,175,0.366,22,71,0.310,42,104,0.404,0.429,16,39,0.410,29,71,100,40,34,6,14,27,166,NYK,2013
6029,Amar'e Stoudemire,30,29,0,682,154,267,0.577,0,0,,154,267,0.577,0.577,105,130,0.808,60,85,145,13,10,21,50,89,413,NYK,2013
6030,James White,30,57,16,435,50,116,0.431,14,41,0.341,36,75,0.480,0.491,11,19,0.579,5,43,48,29,13,4,17,44,125,NYK,2013
6031,Kenyon Martin,35,18,11,431,56,93,0.602,0,0,,56,93,0.602,0.602,17,40,0.425,34,61,95,8,16,17,16,64,129,NYK,2013
6032,Kurt Thomas,40,39,17,392,45,83,0.542,1,1,1.000,44,82,0.537,0.548,6,13,0.462,24,65,89,21,10,16,8,52,97,NYK,2013
6033,Rasheed Wallace,38,21,0,296,55,142,0.387,22,69,0.319,33,73,0.452,0.465,14,20,0.700,11,72,83,6,13,15,10,40,146,NYK,2013
6034,Marcus Camby,38,24,4,250,17,53,0.321,0,0,,17,53,0.321,0.321,8,19,0.421,24,56,80,14,7,14,15,28,42,NYK,2013
6035,Earl Barron,31,1,1,37,5,14,0.357,0,0,,5,14,0.357,0.357,1,2,0.500,6,12,18,2,0,1,1,1,11,NYK,2013
6036,Quentin Richardson,32,1,0,29,1,11,0.091,1,4,0.250,0,7,0.000,0.136,2,2,1.000,5,5,10,1,0,0,2,1,5,NYK,2013
6037,Solomon Jones,28,2,1,26,0,1,0.000,0,0,,0,1,0.000,0.000,0,0,,1,2,3,0,0,1,3,3,0,NYK,2013
6038,Deron Williams,28,78,78,2842,495,1124,0.440,169,447,0.378,326,677,0.482,0.516,317,369,0.859,29,203,232,604,75,30,218,194,1476,BRK,2013
6039,Joe Johnson,31,72,72,2642,445,1052,0.423,148,395,0.375,297,657,0.452,0.493,132,161,0.820,53,165,218,253,49,14,123,99,1170,BRK,2013
6040,Brook Lopez,24,74,74,2253,570,1094,0.521,0,1,0.000,570,1093,0.522,0.521,297,392,0.758,208,304,512,70,33,154,131,152,1437,BRK,2013
6041,Gerald Wallace,30,69,68,2076,182,458,0.397,46,163,0.282,136,295,0.461,0.448,121,190,0.637,69,250,319,181,97,46,110,118,531,BRK,2013
6042,Reggie Evans,32,80,56,1967,125,261,0.479,0,0,,125,261,0.479,0.479,113,222,0.509,260,628,888,43,74,13,111,199,363,BRK,2013
6043,Andray Blatche,26,82,8,1555,346,676,0.512,3,22,0.136,343,654,0.524,0.514,148,216,0.685,161,256,417,85,86,54,123,163,843,BRK,2013
6044,C.J. Watson,28,80,8,1521,192,459,0.418,88,214,0.411,104,245,0.424,0.514,71,91,0.780,38,107,145,161,66,12,69,123,543,BRK,2013
6045,Keith Bogans,32,74,23,1408,108,284,0.380,84,245,0.343,24,39,0.615,0.528,11,17,0.647,16,104,120,76,28,4,49,108,311,BRK,2013
6046,Kris Humphries,27,65,21,1191,139,310,0.448,0,2,0.000,139,308,0.451,0.448,97,123,0.789,126,239,365,32,16,33,57,127,375,BRK,2013
6047,MarShon Brooks,24,73,2,912,155,335,0.463,15,55,0.273,140,280,0.500,0.485,69,94,0.734,32,72,104,76,34,16,69,93,394,BRK,2013
6048,Jerry Stackhouse,38,37,0,544,66,172,0.384,30,89,0.337,36,83,0.434,0.471,20,23,0.870,5,28,33,35,7,4,24,31,182,BRK,2013
6049,Mirza Teletović,27,53,0,499,71,185,0.384,37,108,0.343,34,77,0.442,0.484,9,11,0.818,33,62,95,23,13,8,20,53,188,BRK,2013
6050,Tyshawn Taylor,22,38,0,221,32,87,0.368,6,13,0.462,26,74,0.351,0.402,15,27,0.556,2,16,18,21,13,0,25,25,85,BRK,2013
6051,Josh Childress,29,14,0,100,6,21,0.286,1,3,0.333,5,18,0.278,0.310,1,2,0.500,6,9,15,5,2,2,0,3,14,BRK,2013
6052,Tornike Shengelia,21,19,0,93,10,23,0.435,1,2,0.500,9,21,0.429,0.457,9,16,0.563,9,14,23,3,3,1,11,11,30,BRK,2013
6053,Kris Joseph,24,4,0,30,0,3,0.000,0,1,0.000,0,2,0.000,0.000,2,4,0.500,0,2,2,0,3,0,0,1,2,BRK,2013
6054,Damion James,25,2,0,0,0,0,,0,0,,0,0,,,0,0,,0,1,1,0,0,0,0,0,0,BRK,2013
6055,DeMar DeRozan,23,82,82,3013,548,1231,0.445,34,120,0.283,514,1111,0.463,0.459,355,427,0.831,48,272,320,204,76,24,151,173,1485,TOR,2013
6056,Amir Johnson,25,81,38,2325,336,606,0.554,5,13,0.385,331,593,0.558,0.559,136,187,0.727,227,384,611,122,81,110,117,301,813,TOR,2013
6057,Kyle Lowry,26,68,52,2020,250,623,0.401,101,279,0.362,149,344,0.433,0.482,190,239,0.795,56,265,321,435,94,24,157,218,791,TOR,2013
6058,Alan Anderson,30,65,2,1495,236,616,0.383,95,285,0.333,141,331,0.426,0.460,126,147,0.857,34,114,148,103,48,7,80,131,693,TOR,2013
6059,Jonas Valančiūnas,20,62,57,1482,204,366,0.557,0,0,,204,366,0.557,0.557,146,185,0.789,121,251,372,45,17,78,94,188,554,TOR,2013
6060,José Calderón,31,45,30,1273,187,398,0.470,79,184,0.429,108,214,0.505,0.569,47,52,0.904,14,92,106,333,28,6,75,58,500,TOR,2013
5414,Chandler Parsons,25,74,74,2783,466,987,0.472,130,351,0.370,336,636,0.528,0.538,164,221,0.742,69,340,409,298,88,29,144,168,1226,HOU,2014
5415,James Harden,24,73,73,2777,549,1205,0.456,177,483,0.366,372,722,0.515,0.529,576,665,0.866,61,283,344,446,115,29,265,177,1851,HOU,2014
5416,Dwight Howard,28,71,71,2396,473,800,0.591,2,7,0.286,471,793,0.594,0.593,349,638,0.547,231,635,866,131,60,128,229,240,1297,HOU,2014
5417,Terrence Jones,22,76,71,2078,386,712,0.542,31,101,0.307,355,611,0.581,0.564,118,195,0.605,162,366,528,87,53,99,71,139,921,HOU,2014
5418,Jeremy Lin,25,71,33,2054,295,662,0.446,82,229,0.358,213,433,0.492,0.508,218,265,0.823,34,153,187,294,68,27,176,166,890,HOU,2014
5419,Patrick Beverley,25,56,55,1751,199,481,0.414,92,255,0.361,107,226,0.473,0.509,83,102,0.814,72,124,196,151,77,23,66,174,573,HOU,2014
5420,Omri Casspi,25,71,2,1283,173,410,0.422,61,176,0.347,112,234,0.479,0.496,83,122,0.680,55,205,260,88,44,14,72,100,490,HOU,2014
5421,Francisco García,32,55,4,1083,118,294,0.401,69,193,0.358,49,101,0.485,0.519,10,19,0.526,21,101,122,63,27,33,30,120,315,HOU,2014
5422,Ömer Aşık,27,48,19,968,101,190,0.532,0,0,,101,190,0.532,0.532,78,126,0.619,101,277,378,25,14,37,59,92,280,HOU,2014
5423,Donatas Motiejūnas,23,62,3,952,131,296,0.443,21,84,0.250,110,212,0.519,0.478,58,96,0.604,60,165,225,34,20,21,49,132,341,HOU,2014
5424,Aaron Brooks,29,43,0,716,104,263,0.395,54,132,0.409,50,131,0.382,0.498,37,44,0.841,23,39,62,83,25,6,51,76,299,HOU,2014
5425,Jordan Hamilton,23,21,1,349,48,122,0.393,25,69,0.362,23,53,0.434,0.496,17,20,0.850,9,52,61,18,13,7,19,36,138,HOU,2014
5426,Isaiah Canaan,22,22,0,252,31,87,0.356,18,55,0.327,13,32,0.406,0.460,21,29,0.724,7,17,24,22,8,4,21,25,101,HOU,2014
5427,Ronnie Brewer,28,23,3,158,3,15,0.200,1,8,0.125,2,7,0.286,0.233,0,2,0.000,2,12,14,10,6,1,2,4,7,HOU,2014
5428,Greg Smith,23,11,0,100,18,28,0.643,0,0,,18,28,0.643,0.643,2,5,0.400,11,16,27,0,1,2,5,17,38,HOU,2014
5429,Troy Daniels,22,5,1,75,15,31,0.484,12,25,0.480,3,6,0.500,0.677,0,0,,0,4,4,5,0,0,3,6,42,HOU,2014
5430,Robert Covington,23,7,0,34,6,14,0.429,4,11,0.364,2,3,0.667,0.571,0,0,,2,3,5,0,2,0,1,3,16,HOU,2014
5431,Josh Powell,31,1,0,19,2,6,0.333,0,0,,2,6,0.333,0.333,0,0,,0,5,5,0,0,1,1,1,4,HOU,2014
5432,Thaddeus Young,25,79,78,2718,582,1283,0.454,90,292,0.308,492,991,0.496,0.489,163,229,0.712,166,310,476,182,167,36,165,213,1417,PHI,2014
5433,Michael Carter-Williams,22,70,70,2414,427,1054,0.405,55,208,0.264,372,846,0.440,0.431,258,367,0.703,101,336,437,441,130,43,247,213,1167,PHI,2014
5434,James Anderson,24,80,62,2309,309,717,0.431,115,351,0.328,194,366,0.530,0.511,77,106,0.726,59,241,300,149,74,28,106,154,810,PHI,2014
5435,Evan Turner,25,54,54,1886,356,831,0.428,38,132,0.288,318,699,0.455,0.451,189,228,0.829,50,272,322,198,56,5,155,147,939,PHI,2014
5436,Tony Wroten,20,72,16,1765,345,808,0.427,40,188,0.213,305,620,0.492,0.452,209,326,0.641,69,159,228,217,78,16,204,151,939,PHI,2014
5437,Hollis Thompson,22,77,41,1742,171,372,0.460,67,167,0.401,104,205,0.507,0.550,52,73,0.712,73,174,247,73,53,12,60,144,461,PHI,2014
5438,Spencer Hawes,25,53,53,1666,264,586,0.451,81,203,0.399,183,383,0.478,0.520,79,101,0.782,88,364,452,176,31,67,119,154,688,PHI,2014
5439,Elliot Williams,24,67,2,1157,140,337,0.415,37,125,0.296,103,212,0.486,0.470,87,119,0.731,30,100,130,72,35,3,68,126,404,PHI,2014
5440,Lavoy Allen,24,51,2,960,117,266,0.440,2,13,0.154,115,253,0.455,0.444,27,40,0.675,106,171,277,65,22,27,40,115,263,PHI,2014
5441,Henry Sims,23,26,25,707,112,229,0.489,0,1,0.000,112,228,0.491,0.489,82,107,0.766,82,99,181,47,23,13,33,84,306,PHI,2014
5442,Brandon Davies,22,51,0,575,54,128,0.422,2,10,0.200,52,118,0.441,0.430,34,53,0.642,38,71,109,28,24,8,35,92,144,PHI,2014
5443,Jarvis Varnado,25,23,0,337,36,60,0.600,0,0,,36,60,0.600,0.600,27,52,0.519,19,44,63,13,10,29,10,61,99,PHI,2014
5444,Daniel Orton,23,22,4,251,21,47,0.447,0,0,,21,47,0.447,0.447,23,30,0.767,16,45,61,15,6,16,18,38,65,PHI,2014
5445,Byron Mullens,24,18,0,247,47,101,0.465,20,50,0.400,27,51,0.529,0.564,8,14,0.571,17,43,60,8,9,8,14,31,122,PHI,2014
5446,Lorenzo Brown,23,26,0,224,26,86,0.302,3,30,0.100,23,56,0.411,0.320,9,13,0.692,8,20,28,41,13,3,16,19,64,PHI,2014
5447,Darius Morris,23,12,0,193,29,67,0.433,10,24,0.417,19,43,0.442,0.507,15,21,0.714,3,10,13,31,8,0,19,21,83,PHI,2014
5448,Arnett Moultrie,23,12,2,187,16,38,0.421,0,0,,16,38,0.421,0.421,4,5,0.800,11,24,35,2,8,4,7,22,36,PHI,2014
5449,Dewayne Dedmon,24,11,0,150,15,29,0.517,0,0,,15,29,0.517,0.517,7,13,0.538,11,38,49,3,0,9,9,28,37,PHI,2014
5450,Casper Ware,24,9,0,116,18,42,0.429,7,21,0.333,11,21,0.524,0.512,5,6,0.833,0,9,9,10,8,0,5,11,48,PHI,2014
5451,Eric Maynor,26,8,0,112,11,29,0.379,4,12,0.333,7,17,0.412,0.448,4,8,0.500,2,13,15,12,4,2,12,4,30,PHI,2014
5452,James Nunnally,23,9,0,111,9,28,0.321,5,15,0.333,4,13,0.308,0.411,3,5,0.600,0,11,11,6,5,1,3,9,26,PHI,2014
5453,Darius Johnson-Odom,24,3,0,15,0,7,0.000,0,3,0.000,0,4,0.000,0.000,0,2,0.000,0,2,2,1,1,0,2,3,0,PHI,2014
5454,Adonis Thomas,20,2,1,13,3,5,0.600,1,2,0.500,2,3,0.667,0.700,0,0,,0,0,0,1,0,0,1,4,7,PHI,2014
5455,Jeff Green,27,82,82,2805,482,1171,0.412,135,396,0.341,347,775,0.448,0.469,283,356,0.795,54,326,380,138,57,47,165,180,1382,BOS,2014
5456,Brandon Bass,28,82,73,2266,352,725,0.486,2,6,0.333,350,719,0.487,0.487,205,239,0.858,161,309,470,87,36,71,102,190,911,BOS,2014
5457,Jared Sullinger,21,74,44,2041,384,899,0.427,56,208,0.269,328,691,0.475,0.458,158,203,0.778,241,360,601,118,35,49,119,251,982,BOS,2014
5458,Avery Bradley,23,60,58,1855,361,825,0.438,79,200,0.395,282,625,0.451,0.485,90,112,0.804,48,178,226,85,63,11,96,145,891,BOS,2014
5459,Gerald Wallace,31,58,16,1416,116,230,0.504,19,64,0.297,97,166,0.584,0.546,47,101,0.465,36,176,212,143,73,14,97,79,298,BOS,2014
5460,Kelly Olynyk,22,70,9,1400,234,502,0.466,40,114,0.351,194,388,0.500,0.506,99,122,0.811,140,225,365,109,35,27,106,227,607,BOS,2014
5461,Kris Humphries,28,69,30,1376,231,461,0.501,0,2,0.000,231,459,0.503,0.501,117,144,0.813,127,282,409,67,31,61,64,136,579,BOS,2014
5462,Jordan Crawford,25,39,35,1198,188,455,0.413,50,157,0.318,138,298,0.463,0.468,110,126,0.873,18,102,120,224,34,3,84,76,536,BOS,2014
5463,Phil Pressey,22,75,11,1132,78,253,0.308,28,106,0.264,50,147,0.340,0.364,29,45,0.644,20,85,105,241,68,5,87,97,213,BOS,2014
5464,Jerryd Bayless,25,41,14,1036,158,378,0.418,51,129,0.395,107,249,0.430,0.485,49,61,0.803,14,72,86,128,40,4,60,89,416,BOS,2014
5465,Rajon Rondo,27,30,30,998,141,350,0.403,26,90,0.289,115,260,0.442,0.440,42,67,0.627,22,142,164,294,40,2,99,65,350,BOS,2014
5466,Chris Johnson,23,40,0,789,85,214,0.397,43,127,0.339,42,87,0.483,0.498,37,43,0.860,31,66,97,31,27,4,22,63,250,BOS,2014
5467,Courtney Lee,28,30,0,504,90,183,0.492,23,52,0.442,67,131,0.511,0.555,18,22,0.818,8,41,49,32,20,9,25,37,221,BOS,2014
5468,Vítor Luiz Faverani,25,37,8,488,64,147,0.435,12,40,0.300,52,107,0.486,0.476,24,37,0.649,42,86,128,16,14,27,41,74,164,BOS,2014
5469,Joel Anthony,31,21,0,149,10,26,0.385,0,0,,10,26,0.385,0.385,2,6,0.333,13,18,31,2,3,8,2,13,22,BOS,2014
5470,Chris Babb,23,14,0,132,8,30,0.267,6,27,0.222,2,3,0.667,0.367,0,0,,4,13,17,3,6,0,3,13,22,BOS,2014
5471,MarShon Brooks,25,10,0,73,9,24,0.375,2,4,0.500,7,20,0.350,0.417,11,14,0.786,1,18,19,4,1,1,7,5,31,BOS,2014
5472,Keith Bogans,33,6,0,55,3,6,0.500,3,6,0.500,0,0,,0.750,3,3,1.000,0,3,3,3,1,0,1,2,12,BOS,2014
5473,Vander Blue,21,3,0,15,2,4,0.500,0,1,0.000,2,3,0.667,0.500,1,5,0.200,0,3,3,1,0,0,2,1,5,BOS,2014
5474,Carmelo Anthony,29,77,77,2982,743,1643,0.452,167,415,0.402,576,1228,0.469,0.503,459,541,0.848,145,477,622,242,95,51,198,224,2112,NYK,2014
5475,J.R. Smith,28,74,37,2421,396,955,0.415,189,480,0.394,207,475,0.436,0.514,90,138,0.652,35,261,296,219,65,20,108,196,1071,NYK,2014
5476,Raymond Felton,29,65,65,2017,240,608,0.395,62,195,0.318,178,413,0.431,0.446,88,122,0.721,54,143,197,365,78,27,129,157,630,NYK,2014
5477,Iman Shumpert,23,74,58,1962,183,484,0.378,76,228,0.333,107,256,0.418,0.457,53,71,0.746,81,227,308,129,92,13,79,209,495,NYK,2014
5478,Tim Hardaway Jr.,21,81,1,1875,294,687,0.428,130,358,0.363,164,329,0.498,0.523,106,128,0.828,19,102,121,66,44,7,47,144,824,NYK,2014
5479,Tyson Chandler,31,55,55,1662,191,322,0.593,0,1,0.000,191,321,0.595,0.593,98,155,0.632,159,370,529,59,36,63,71,145,480,NYK,2014
5480,Amar'e Stoudemire,31,65,21,1466,311,558,0.557,0,0,,311,558,0.557,0.557,150,203,0.739,112,208,320,34,23,37,91,159,772,NYK,2014
5481,Pablo Prigioni,36,66,27,1283,88,191,0.461,65,140,0.464,23,51,0.451,0.631,11,12,0.917,36,93,129,228,67,2,60,132,252,NYK,2014
5482,Andrea Bargnani,28,42,39,1257,222,502,0.442,30,108,0.278,192,394,0.487,0.472,84,102,0.824,69,153,222,45,14,52,58,100,558,NYK,2014
5483,Kenyon Martin,36,32,15,633,63,123,0.512,0,1,0.000,63,122,0.516,0.512,11,19,0.579,36,98,134,50,25,27,26,85,137,NYK,2014
5484,Beno Udrih,31,31,12,588,68,160,0.425,17,40,0.425,51,120,0.425,0.478,20,24,0.833,10,47,57,110,22,3,42,46,173,NYK,2014
5485,Jeremy Tyler,22,41,0,398,60,116,0.517,0,0,,60,116,0.517,0.517,26,48,0.542,38,71,109,8,6,20,26,70,146,NYK,2014
5486,Metta World Peace,34,29,1,388,56,141,0.397,17,54,0.315,39,87,0.448,0.457,10,16,0.625,18,41,59,17,24,8,19,44,139,NYK,2014
5487,Toure' Murry,24,51,0,373,56,129,0.434,5,12,0.417,51,117,0.436,0.453,23,39,0.590,13,31,44,49,19,1,34,46,140,NYK,2014
5488,Cole Aldrich,25,46,2,330,33,61,0.541,0,0,,33,61,0.541,0.541,26,30,0.867,37,92,129,14,8,30,18,40,92,NYK,2014
5489,Shannon Brown,28,19,0,148,16,38,0.421,0,0,,16,38,0.421,0.421,8,12,0.667,6,9,15,4,12,0,10,12,40,NYK,2014
5490,Earl Clark,26,9,0,70,7,21,0.333,1,6,0.167,6,15,0.400,0.357,8,10,0.800,2,14,16,2,1,6,1,6,23,NYK,2014
5491,Chris Smith,26,2,0,2,0,0,,0,0,,0,0,,,0,0,,0,0,0,0,0,0,0,0,0,NYK,2014
5492,Joe Johnson,32,79,79,2575,462,1018,0.454,162,404,0.401,300,614,0.489,0.533,159,195,0.815,48,222,270,216,47,10,120,129,1245,BRK,2014
5493,Paul Pierce,36,75,68,2098,321,712,0.451,112,300,0.373,209,412,0.507,0.529,256,310,0.826,26,322,348,178,86,31,153,190,1010,BRK,2014
5494,Deron Williams,29,64,58,2059,322,716,0.450,98,268,0.366,224,448,0.500,0.518,173,216,0.801,15,153,168,392,93,13,143,148,915,BRK,2014
5495,Shaun Livingston,28,76,54,1974,235,487,0.483,1,6,0.167,234,481,0.486,0.484,158,191,0.827,67,179,246,245,93,31,105,172,629,BRK,2014
5496,Alan Anderson,31,78,26,1773,194,485,0.400,84,248,0.339,110,237,0.464,0.487,92,118,0.780,40,135,175,81,48,11,62,147,564,BRK,2014
5497,Andray Blatche,27,73,7,1618,321,674,0.476,15,54,0.278,306,620,0.494,0.487,164,221,0.742,120,270,390,112,75,38,110,166,821,BRK,2014
5498,Mirza Teletović,28,72,7,1396,221,529,0.418,136,349,0.390,85,180,0.472,0.546,44,62,0.710,60,206,266,57,29,23,54,143,622,BRK,2014
5499,Mason Plumlee,23,70,22,1275,199,302,0.659,0,3,0.000,199,299,0.666,0.659,122,195,0.626,99,209,308,60,49,55,77,171,520,BRK,2014
5500,Kevin Garnett,37,54,54,1109,157,356,0.441,0,3,0.000,157,353,0.445,0.441,38,47,0.809,60,298,358,82,43,40,69,123,352,BRK,2014
5501,Andrei Kirilenko,32,45,4,857,82,160,0.513,1,5,0.200,81,155,0.523,0.516,61,119,0.513,55,91,146,72,40,19,54,65,226,BRK,2014
5502,Marcus Thornton,26,26,1,620,110,266,0.414,52,137,0.380,58,129,0.450,0.511,48,60,0.800,18,56,74,30,27,3,29,36,320,BRK,2014
5503,Jason Terry,36,35,0,570,55,152,0.362,39,103,0.379,16,49,0.327,0.490,10,15,0.667,4,33,37,56,13,0,27,48,159,BRK,2014
5504,Brook Lopez,25,17,17,533,129,229,0.563,0,1,0.000,129,228,0.566,0.563,94,115,0.817,39,63,102,16,9,30,28,52,352,BRK,2014
5505,Reggie Evans,33,30,6,399,23,59,0.390,0,0,,23,59,0.390,0.390,35,65,0.538,53,96,149,5,13,2,28,54,81,BRK,2014
5506,Tyshawn Taylor,23,23,3,270,31,91,0.341,3,12,0.250,28,79,0.354,0.357,24,30,0.800,3,12,15,36,12,1,31,29,89,BRK,2014
5507,Jorge Gutiérrez,25,15,2,244,25,54,0.463,3,12,0.250,22,42,0.524,0.491,9,12,0.750,3,19,22,30,10,1,14,37,62,BRK,2014
5508,Marquis Teague,20,21,1,201,22,53,0.415,3,8,0.375,19,45,0.422,0.443,15,19,0.789,0,21,21,30,8,1,22,21,62,BRK,2014
5509,Jason Collins,35,22,1,172,11,24,0.458,0,3,0.000,11,21,0.524,0.458,3,4,0.750,7,12,19,4,8,1,7,30,25,BRK,2014
5510,Tornike Shengelia,22,17,0,137,11,24,0.458,0,6,0.000,11,18,0.611,0.458,3,8,0.375,4,10,14,12,2,1,11,16,25,BRK,2014
5511,DeMar DeRozan,24,79,79,3017,604,1407,0.429,64,210,0.305,540,1197,0.451,0.452,519,630,0.824,51,292,343,313,86,28,176,197,1791,TOR,2014
5512,Kyle Lowry,27,79,79,2862,457,1080,0.423,190,500,0.380,267,580,0.460,0.511,313,385,0.813,88,281,369,586,121,15,194,267,1417,TOR,2014
5513,Jonas Valančiūnas,21,81,81,2282,359,676,0.531,0,1,0.000,359,675,0.532,0.531,198,260,0.762,226,488,714,57,24,71,136,249,916,TOR,2014
4839,James Harden,25,81,81,2981,647,1470,0.440,208,555,0.375,439,915,0.480,0.511,715,824,0.868,75,384,459,565,154,60,321,208,2217,HOU,2015
4840,Trevor Ariza,29,82,82,2930,366,910,0.402,194,555,0.350,172,355,0.485,0.509,122,143,0.853,77,382,459,209,152,17,141,186,1048,HOU,2015
4841,Donatas Motiejūnas,24,71,62,2037,353,700,0.504,49,133,0.368,304,567,0.536,0.539,100,166,0.602,137,284,421,130,56,34,123,203,855,HOU,2015
4842,Patrick Beverley,26,56,55,1727,204,532,0.383,115,323,0.356,89,209,0.426,0.492,45,60,0.750,67,170,237,192,59,23,83,182,568,HOU,2015
4843,Jason Terry,37,77,18,1641,188,446,0.422,126,323,0.390,62,123,0.504,0.563,39,48,0.813,15,106,121,147,66,19,74,116,541,HOU,2015
4844,Corey Brewer,28,56,1,1407,249,580,0.429,55,194,0.284,194,386,0.503,0.477,113,148,0.764,48,155,203,95,60,15,81,111,666,HOU,2015
4845,Josh Smith,29,55,7,1404,261,596,0.438,63,191,0.330,198,405,0.489,0.491,75,144,0.521,100,228,328,145,50,68,134,146,660,HOU,2015
4846,Dwight Howard,29,41,41,1223,251,423,0.593,1,2,0.500,250,421,0.594,0.595,143,271,0.528,110,321,431,50,28,53,115,137,646,HOU,2015
4847,Terrence Jones,23,33,24,889,158,299,0.528,13,37,0.351,145,262,0.553,0.550,57,94,0.606,78,142,220,36,18,59,37,78,386,HOU,2015
4848,Joey Dorsey,31,69,17,854,80,145,0.552,0,1,0.000,80,144,0.556,0.552,24,83,0.289,103,176,279,25,40,25,41,157,184,HOU,2015
4849,Kostas Papanikolaou,24,43,1,795,69,197,0.350,31,106,0.292,38,91,0.418,0.429,13,18,0.722,39,79,118,85,29,13,55,71,182,HOU,2015
4850,Pablo Prigioni,37,24,0,402,23,67,0.343,14,51,0.275,9,16,0.563,0.448,13,15,0.867,12,27,39,67,27,0,15,35,73,HOU,2015
4851,Tarik Black,23,25,12,393,45,83,0.542,0,1,0.000,45,82,0.549,0.542,15,29,0.517,58,69,127,8,6,2,19,56,105,HOU,2015
4852,Isaiah Canaan,23,25,9,369,53,131,0.405,32,84,0.381,21,47,0.447,0.527,16,21,0.762,11,22,33,29,14,0,23,28,154,HOU,2015
4853,Nick Johnson,22,28,0,262,26,75,0.347,5,21,0.238,21,54,0.389,0.380,17,25,0.680,13,26,39,11,7,3,19,34,74,HOU,2015
4854,Francisco García,33,14,0,200,17,63,0.270,10,45,0.222,7,18,0.389,0.349,1,4,0.250,3,14,17,15,9,5,10,20,45,HOU,2015
4855,Troy Daniels,23,17,0,108,15,47,0.319,13,43,0.302,2,4,0.500,0.457,3,4,0.750,0,6,6,4,0,0,5,14,46,HOU,2015
4856,Clint Capela,20,12,0,90,14,29,0.483,0,0,,14,29,0.483,0.483,4,23,0.174,10,26,36,2,1,9,5,14,32,HOU,2015
4857,Alexey Shved,26,9,0,59,8,24,0.333,4,12,0.333,4,12,0.333,0.417,9,11,0.818,1,3,4,3,1,0,5,2,29,HOU,2015
4858,K.J. McDaniels,21,10,0,33,5,15,0.333,0,3,0.000,5,12,0.417,0.333,1,2,0.500,1,4,5,2,0,2,1,5,11,HOU,2015
4859,Nerlens Noel,20,75,71,2311,302,653,0.462,0,0,,302,653,0.462,0.462,140,230,0.609,185,426,611,128,133,142,146,208,744,PHI,2015
4860,Robert Covington,24,70,49,1956,299,756,0.396,167,446,0.374,132,310,0.426,0.506,178,217,0.820,65,251,316,105,97,31,128,189,943,PHI,2015
4861,Luc Mbah a Moute,28,67,61,1916,251,636,0.395,62,202,0.307,189,434,0.435,0.443,96,163,0.589,82,246,328,106,81,21,99,104,660,PHI,2015
4862,Hollis Thompson,23,71,23,1776,224,543,0.413,115,287,0.401,109,256,0.426,0.518,63,89,0.708,53,145,198,85,57,26,66,141,626,PHI,2015
4863,Henry Sims,24,73,32,1399,238,502,0.474,4,22,0.182,234,480,0.488,0.478,106,137,0.774,121,238,359,79,39,30,99,135,586,PHI,2015
4864,Michael Carter-Williams,23,41,38,1391,232,611,0.380,32,125,0.256,200,486,0.412,0.406,117,182,0.643,43,211,254,302,60,18,174,103,613,PHI,2015
4865,Jerami Grant,20,65,11,1377,124,352,0.352,49,156,0.314,75,196,0.383,0.422,114,193,0.591,49,149,198,79,40,68,85,144,411,PHI,2015
4866,K.J. McDaniels,21,52,15,1319,167,419,0.399,43,147,0.293,124,272,0.456,0.450,99,131,0.756,64,131,195,70,44,68,104,121,476,PHI,2015
4867,JaKarr Sampson,21,74,32,1131,146,346,0.422,31,127,0.244,115,219,0.525,0.467,63,94,0.670,35,128,163,77,38,26,76,135,386,PHI,2015
4868,Tony Wroten,21,30,15,895,175,434,0.403,37,142,0.261,138,292,0.473,0.446,120,180,0.667,22,64,86,157,48,8,113,72,507,PHI,2015
4869,Ish Smith,26,25,14,677,128,322,0.398,17,55,0.309,111,267,0.416,0.424,28,48,0.583,10,63,73,152,32,5,69,38,301,PHI,2015
4870,Isaiah Canaan,23,22,12,569,93,247,0.377,59,162,0.364,34,85,0.400,0.496,33,39,0.846,7,47,54,69,15,3,39,55,278,PHI,2015
4871,Furkan Aldemir,23,41,9,540,40,78,0.513,0,5,0.000,40,73,0.548,0.513,13,27,0.481,78,98,176,28,17,16,17,96,93,PHI,2015
4872,Jason Richardson,34,19,15,416,62,178,0.348,31,96,0.323,31,82,0.378,0.435,17,22,0.773,13,53,66,38,13,3,16,28,172,PHI,2015
4873,Thomas Robinson,23,22,0,407,79,169,0.467,0,2,0.000,79,167,0.473,0.467,35,58,0.603,62,108,170,24,16,9,26,50,193,PHI,2015
4874,Brandon Davies,23,20,6,379,49,119,0.412,7,30,0.233,42,89,0.472,0.441,21,33,0.636,35,38,73,28,17,4,25,54,126,PHI,2015
4875,Alexey Shved,26,17,0,285,52,130,0.400,17,57,0.298,35,73,0.479,0.465,48,57,0.842,8,14,22,46,14,1,18,21,169,PHI,2015
4876,Larry Drew II,24,12,1,219,20,58,0.345,4,26,0.154,16,32,0.500,0.379,2,3,0.667,1,14,15,45,6,0,25,13,46,PHI,2015
4877,Malcolm Thomas,26,17,0,194,18,40,0.450,0,7,0.000,18,33,0.545,0.450,9,13,0.692,16,40,56,7,3,1,13,17,45,PHI,2015
4878,Chris Johnson,24,9,2,187,19,60,0.317,10,39,0.256,9,21,0.429,0.400,6,8,0.750,3,23,26,3,9,5,9,19,54,PHI,2015
4879,Tim Frazier,24,6,3,171,13,43,0.302,3,11,0.273,10,32,0.313,0.337,5,15,0.333,4,15,19,43,6,0,18,16,34,PHI,2015
4880,Glenn Robinson III,21,10,1,153,18,43,0.419,4,13,0.308,14,30,0.467,0.465,4,8,0.500,11,14,25,8,3,1,8,10,44,PHI,2015
4881,Drew Gordon,24,9,0,71,8,19,0.421,0,3,0.000,8,16,0.500,0.421,1,2,0.500,7,11,18,2,1,0,8,7,17,PHI,2015
4882,JaVale McGee,27,6,0,61,8,18,0.444,0,0,,8,18,0.444,0.444,2,4,0.500,4,9,13,2,0,1,5,2,18,PHI,2015
4883,Malcolm Lee,24,1,0,2,0,1,0.000,0,0,,0,1,0.000,0.000,0,0,,0,0,0,0,0,0,0,0,0,PHI,2015
4884,Avery Bradley,24,77,77,2428,434,1012,0.429,124,352,0.352,310,660,0.470,0.490,79,100,0.790,46,195,241,135,82,15,109,177,1071,BOS,2015
4885,Evan Turner,26,82,57,2260,320,746,0.429,33,119,0.277,287,627,0.458,0.451,106,141,0.752,40,377,417,449,83,19,198,180,779,BOS,2015
4886,Brandon Bass,29,82,43,1929,344,683,0.504,9,32,0.281,335,651,0.515,0.510,169,214,0.790,139,259,398,104,41,32,83,140,866,BOS,2015
4887,Marcus Smart,20,67,38,1808,175,477,0.367,91,272,0.335,84,205,0.410,0.462,82,127,0.646,61,161,222,208,99,18,90,176,523,BOS,2015
4888,Tyler Zeller,25,82,59,1731,340,619,0.549,0,0,,340,619,0.549,0.549,153,186,0.823,146,319,465,113,18,52,76,205,833,BOS,2015
4889,Jared Sullinger,22,58,49,1566,311,708,0.439,52,184,0.283,259,524,0.494,0.476,96,129,0.744,147,294,441,134,44,42,78,153,770,BOS,2015
4890,Kelly Olynyk,23,64,13,1423,251,528,0.475,61,175,0.349,190,353,0.538,0.533,93,136,0.684,92,211,303,109,64,39,98,213,656,BOS,2015
4891,Jae Crowder,24,57,17,1382,196,469,0.418,48,170,0.282,148,299,0.495,0.469,99,130,0.762,60,204,264,82,57,20,39,111,539,BOS,2015
4892,Jeff Green,28,33,33,1093,206,475,0.434,47,154,0.305,159,321,0.495,0.483,121,144,0.840,21,120,141,53,27,13,56,66,580,BOS,2015
4893,Rajon Rondo,28,22,22,699,81,200,0.405,8,32,0.250,73,168,0.435,0.425,12,36,0.333,25,140,165,237,37,3,75,42,182,BOS,2015
4894,Marcus Thornton,27,39,0,640,127,305,0.416,52,124,0.419,75,181,0.414,0.502,42,51,0.824,19,54,73,34,21,7,22,35,348,BOS,2015
4895,Phil Pressey,23,50,0,600,64,174,0.368,16,65,0.246,48,109,0.440,0.414,33,49,0.673,13,67,80,117,30,6,41,54,177,BOS,2015
4896,Isaiah Thomas,25,21,0,545,117,285,0.411,48,139,0.345,69,146,0.473,0.495,118,137,0.861,7,37,44,113,12,0,54,45,400,BOS,2015
4897,Jonas Jerebko,27,29,0,527,78,181,0.431,26,64,0.406,52,117,0.444,0.503,25,30,0.833,46,94,140,30,19,7,18,58,207,BOS,2015
4898,James Young,19,31,0,332,36,102,0.353,17,66,0.258,19,36,0.528,0.436,16,29,0.552,9,33,42,13,8,2,5,22,105,BOS,2015
4899,Gerald Wallace,32,32,0,286,14,34,0.412,1,3,0.333,13,31,0.419,0.426,6,15,0.400,17,40,57,11,15,4,18,19,35,BOS,2015
4900,Tayshaun Prince,34,9,0,198,33,59,0.559,5,8,0.625,28,51,0.549,0.602,5,6,0.833,6,24,30,18,5,2,4,7,76,BOS,2015
4901,Gigi Datome,27,18,1,192,38,77,0.494,17,36,0.472,21,41,0.512,0.604,1,1,1.000,2,23,25,7,1,7,7,14,94,BOS,2015
4902,Jameer Nelson,32,6,1,121,9,41,0.220,5,25,0.200,4,16,0.250,0.280,6,9,0.667,3,14,17,33,7,0,9,13,29,BOS,2015
4903,Brandan Wright,27,8,0,86,12,21,0.571,0,0,,12,21,0.571,0.571,2,4,0.500,7,10,17,8,1,5,5,4,26,BOS,2015
4904,Shavlik Randolph,31,5,0,25,3,10,0.300,0,1,0.000,3,9,0.333,0.300,1,2,0.500,4,8,12,1,1,1,1,3,7,BOS,2015
4905,Dwight Powell,23,5,0,9,4,5,0.800,0,0,,4,5,0.800,0.800,1,2,0.500,0,1,1,0,2,0,2,1,9,BOS,2015
4906,Shane Larkin,22,76,22,1865,187,432,0.433,35,116,0.302,152,316,0.481,0.473,61,78,0.782,29,147,176,226,93,9,83,150,470,NYK,2015
4907,Jason Smith,28,82,31,1785,257,592,0.434,15,42,0.357,242,550,0.440,0.447,127,153,0.830,98,226,324,140,32,44,104,205,656,NYK,2015
4908,Tim Hardaway Jr.,22,70,30,1681,279,717,0.389,121,354,0.342,158,363,0.435,0.474,125,156,0.801,12,144,156,127,20,14,82,119,804,NYK,2015
4909,Langston Galloway,23,45,41,1457,204,511,0.399,62,176,0.352,142,335,0.424,0.460,63,78,0.808,37,153,190,150,52,12,61,129,533,NYK,2015
4910,Carmelo Anthony,30,40,40,1428,358,806,0.444,61,179,0.341,297,627,0.474,0.482,189,237,0.797,72,192,264,122,40,17,89,87,966,NYK,2015
4911,Quincy Acy,24,68,22,1287,152,331,0.459,18,60,0.300,134,271,0.494,0.486,76,97,0.784,79,222,301,68,27,22,60,147,398,NYK,2015
4912,José Calderón,33,42,42,1270,147,354,0.415,59,142,0.415,88,212,0.415,0.499,29,32,0.906,19,105,124,198,31,0,75,76,382,NYK,2015
4913,Lance Thomas,26,40,24,1040,137,316,0.434,7,21,0.333,130,295,0.441,0.445,49,66,0.742,37,83,120,49,26,8,57,63,330,NYK,2015
4914,Cole Aldrich,26,61,16,976,144,301,0.478,0,0,,144,301,0.478,0.478,50,64,0.781,101,237,338,75,37,65,59,122,338,NYK,2015
4915,Amar'e Stoudemire,32,36,14,865,169,311,0.543,0,3,0.000,169,308,0.549,0.543,94,127,0.740,83,162,245,37,20,34,63,111,432,NYK,2015
4916,Lou Amundson,32,41,35,858,105,243,0.432,0,1,0.000,105,242,0.434,0.432,38,82,0.463,89,159,248,65,21,52,57,115,248,NYK,2015
4917,Pablo Prigioni,37,43,3,795,68,161,0.422,43,115,0.374,25,46,0.543,0.556,22,26,0.846,18,62,80,104,52,1,47,53,201,NYK,2015
4918,Andrea Bargnani,29,29,22,785,164,361,0.454,15,41,0.366,149,320,0.466,0.475,87,107,0.813,32,95,127,46,2,27,42,53,430,NYK,2015
4919,Travis Wear,24,51,1,672,84,209,0.402,11,30,0.367,73,179,0.408,0.428,20,26,0.769,31,75,106,40,15,11,35,55,199,NYK,2015
4920,Cleanthony Early,23,39,7,647,76,214,0.355,22,84,0.262,54,130,0.415,0.407,36,48,0.750,22,75,97,36,24,12,40,57,210,NYK,2015
4921,Iman Shumpert,24,24,24,625,88,215,0.409,23,66,0.348,65,149,0.436,0.463,25,37,0.676,22,59,81,78,30,3,42,67,224,NYK,2015
4922,J.R. Smith,29,24,6,619,101,251,0.402,32,90,0.356,69,161,0.429,0.466,27,39,0.692,4,54,58,81,18,4,45,44,261,NYK,2015
4923,Samuel Dalembert,33,32,21,544,57,130,0.438,0,0,,57,130,0.438,0.438,14,20,0.700,53,115,168,29,14,41,39,70,128,NYK,2015
4924,Alexey Shved,26,16,9,423,73,181,0.403,26,70,0.371,47,111,0.423,0.475,64,82,0.780,14,59,73,57,15,5,25,25,236,NYK,2015
4925,Ricky Ledo,22,12,0,233,32,90,0.356,10,24,0.417,22,66,0.333,0.411,15,20,0.750,15,19,34,18,6,1,24,20,89,NYK,2015
4926,Joe Johnson,33,80,80,2791,446,1025,0.435,121,337,0.359,325,688,0.472,0.494,141,176,0.801,53,331,384,292,59,14,137,120,1154,BRK,2015
4927,Jarrett Jack,31,80,27,2241,359,817,0.439,39,146,0.267,320,671,0.477,0.463,200,227,0.881,19,226,245,373,75,13,191,143,957,BRK,2015
4928,Deron Williams,30,68,55,2114,298,771,0.387,87,237,0.367,211,534,0.395,0.443,201,241,0.834,29,208,237,448,64,17,154,157,884,BRK,2015
4929,Brook Lopez,26,72,44,2100,506,987,0.513,1,10,0.100,505,977,0.517,0.513,223,274,0.814,214,321,535,50,43,126,104,206,1236,BRK,2015
4930,Bojan Bogdanović,25,78,28,1854,261,576,0.453,91,256,0.355,170,320,0.531,0.532,87,106,0.821,50,163,213,68,34,9,78,104,700,BRK,2015
4931,Alan Anderson,32,74,19,1744,195,440,0.443,73,210,0.348,122,230,0.530,0.526,82,101,0.812,31,173,204,83,56,5,60,148,545,BRK,2015
4932,Mason Plumlee,24,82,45,1743,280,489,0.573,0,3,0.000,280,486,0.576,0.573,157,317,0.495,175,337,512,74,65,63,106,207,717,BRK,2015
4933,Mirza Teletović,29,40,4,892,122,319,0.382,62,193,0.321,60,126,0.476,0.480,33,46,0.717,27,167,194,46,14,16,53,74,339,BRK,2015
4934,Kevin Garnett,38,42,42,854,125,275,0.455,1,6,0.167,124,269,0.461,0.456,34,41,0.829,46,239,285,69,41,13,45,96,285,BRK,2015
4935,Thaddeus Young,26,28,20,829,162,327,0.495,19,50,0.380,143,277,0.516,0.524,43,71,0.606,52,114,166,38,38,8,42,56,386,BRK,2015
4936,Markel Brown,23,47,29,781,76,210,0.362,17,64,0.266,59,146,0.404,0.402,47,57,0.825,16,91,107,39,31,12,27,57,216,BRK,2015
4937,Sergey Karasev,21,33,16,555,54,134,0.403,16,54,0.296,38,80,0.475,0.463,29,38,0.763,22,44,66,46,23,1,24,45,153,BRK,2015
4938,Cory Jefferson,24,50,1,531,75,167,0.449,2,15,0.133,73,152,0.480,0.455,31,54,0.574,47,98,145,16,10,21,20,61,183,BRK,2015
4311,James Harden,26,82,82,3125,710,1617,0.439,236,657,0.359,474,960,0.494,0.512,720,837,0.860,63,438,501,612,139,51,374,229,2376,HOU,2016
4312,Trevor Ariza,30,81,81,2859,357,859,0.416,185,499,0.371,172,360,0.478,0.523,126,161,0.783,67,299,366,188,160,26,113,177,1025,HOU,2016
4313,Dwight Howard,30,71,71,2280,372,600,0.620,0,6,0.000,372,594,0.626,0.620,232,474,0.489,238,597,835,98,69,113,166,219,976,HOU,2016
4314,Patrick Beverley,27,71,63,2041,258,594,0.434,124,310,0.400,134,284,0.472,0.539,60,88,0.682,73,177,250,239,94,26,91,234,700,HOU,2016
4315,Corey Brewer,29,82,12,1669,212,552,0.384,61,224,0.272,151,328,0.460,0.439,105,140,0.750,42,157,199,109,84,19,78,168,590,HOU,2016
4316,Clint Capela,21,77,35,1471,231,397,0.582,0,1,0.000,231,396,0.583,0.582,80,211,0.379,194,300,494,47,59,92,60,190,542,HOU,2016
4317,Jason Terry,38,72,7,1258,151,376,0.402,93,261,0.356,58,115,0.504,0.525,27,33,0.818,14,65,79,103,47,9,49,91,422,HOU,2016
4318,Ty Lawson,28,53,12,1176,111,287,0.387,31,94,0.330,80,193,0.415,0.441,56,80,0.700,20,69,89,180,43,6,82,71,309,HOU,2016
4319,Terrence Jones,24,50,11,1044,166,367,0.452,25,79,0.316,141,288,0.490,0.486,77,116,0.664,62,149,211,41,23,39,49,86,434,HOU,2016
4320,Marcus Thornton,28,47,6,885,174,435,0.400,73,216,0.338,101,219,0.461,0.484,51,58,0.879,31,84,115,66,34,3,40,73,472,HOU,2016
4321,Donatas Motiejūnas,25,37,22,547,90,205,0.439,16,57,0.281,74,148,0.500,0.478,34,53,0.642,37,72,109,41,17,5,44,69,230,HOU,2016
4322,Josh Smith,30,23,6,421,58,169,0.343,23,85,0.271,35,84,0.417,0.411,12,25,0.480,18,49,67,48,16,13,36,56,151,HOU,2016
4323,Montrezl Harrell,22,39,1,379,58,90,0.644,0,1,0.000,58,89,0.652,0.644,24,46,0.522,25,40,65,17,11,11,17,48,140,HOU,2016
4324,Michael Beasley,27,20,0,363,107,205,0.522,3,9,0.333,104,196,0.531,0.529,38,49,0.776,29,69,98,16,11,9,24,39,255,HOU,2016
4325,K.J. McDaniels,22,37,1,235,29,72,0.403,7,25,0.280,22,47,0.468,0.451,24,30,0.800,16,26,42,10,7,6,17,30,89,HOU,2016
4326,Andrew Goudelock,27,8,0,50,9,20,0.450,1,9,0.111,8,11,0.727,0.475,3,4,0.750,1,1,2,4,6,2,7,4,22,HOU,2016
4327,Chuck Hayes,32,2,0,24,1,2,0.500,0,0,,1,2,0.500,0.500,2,2,1.000,0,8,8,2,0,0,3,6,4,HOU,2016
4328,Sam Dekker,21,3,0,6,0,0,,0,0,,0,0,,,0,0,,0,1,1,0,1,0,0,0,0,HOU,2016
4329,Hollis Thompson,24,77,17,2154,270,680,0.397,149,392,0.380,121,288,0.420,0.507,69,96,0.719,54,218,272,99,36,24,76,187,758,PHI,2016
4330,Jerami Grant,21,77,52,2066,251,599,0.419,35,146,0.240,216,453,0.477,0.448,212,322,0.658,99,262,361,135,54,127,110,215,749,PHI,2016
4331,Isaiah Canaan,24,77,39,1966,260,722,0.360,176,485,0.363,84,237,0.354,0.482,150,180,0.833,20,154,174,137,56,12,91,133,846,PHI,2016
4332,Nerlens Noel,21,67,62,1965,306,587,0.521,1,2,0.500,305,585,0.521,0.522,134,227,0.590,154,388,542,122,118,100,158,192,747,PHI,2016
4333,Robert Covington,25,67,49,1903,274,712,0.385,170,482,0.353,104,230,0.452,0.504,140,177,0.791,65,354,419,97,105,40,143,232,858,PHI,2016
4334,Nik Stauskas,22,73,35,1809,210,545,0.385,106,325,0.326,104,220,0.473,0.483,91,118,0.771,23,160,183,138,44,20,94,115,617,PHI,2016
4335,Ish Smith,27,50,50,1622,299,739,0.405,46,137,0.336,253,602,0.420,0.436,89,133,0.669,29,184,213,348,64,18,130,95,733,PHI,2016
4336,T.J. McConnell,23,81,17,1606,218,464,0.470,31,89,0.348,187,375,0.499,0.503,26,41,0.634,43,207,250,367,95,10,140,114,493,PHI,2016
4337,Jahlil Okafor,20,53,48,1591,397,781,0.508,1,6,0.167,396,775,0.511,0.509,133,194,0.686,122,251,373,65,22,61,124,140,928,PHI,2016
4338,Richaun Holmes,22,51,1,702,114,222,0.514,8,44,0.182,106,178,0.596,0.532,51,74,0.689,62,73,135,33,19,40,32,92,287,PHI,2016
4339,JaKarr Sampson,22,47,18,691,86,202,0.426,6,34,0.176,80,168,0.476,0.441,62,97,0.639,30,99,129,30,11,16,51,91,240,PHI,2016
4340,Carl Landry,32,36,12,569,139,250,0.556,6,13,0.462,133,237,0.561,0.568,67,91,0.736,49,97,146,32,12,9,22,69,351,PHI,2016
4341,Kendall Marshall,24,30,6,400,43,118,0.364,16,49,0.327,27,69,0.391,0.432,9,13,0.692,2,26,28,73,16,2,43,30,111,PHI,2016
4342,Elton Brand,36,17,1,225,31,72,0.431,0,1,0.000,31,71,0.437,0.431,8,9,0.889,9,54,63,18,9,8,11,32,70,PHI,2016
4343,Phil Pressey,24,14,0,170,21,55,0.382,4,13,0.308,17,42,0.405,0.418,9,18,0.500,0,23,23,46,11,1,19,14,55,PHI,2016
4344,Christian Wood,20,17,0,145,22,53,0.415,4,11,0.364,18,42,0.429,0.453,13,21,0.619,13,25,38,3,5,7,2,11,61,PHI,2016
4345,Tony Wroten,22,8,3,144,22,65,0.338,3,17,0.176,19,48,0.396,0.362,20,37,0.541,2,19,21,20,3,0,29,11,67,PHI,2016
4346,Sonny Weems,29,7,0,78,7,21,0.333,2,9,0.222,5,12,0.417,0.381,1,2,0.500,1,11,12,2,0,0,4,7,17,PHI,2016
4347,Isaiah Thomas,26,82,79,2644,591,1382,0.428,167,465,0.359,424,917,0.462,0.488,474,544,0.871,46,197,243,509,91,9,220,167,1823,BOS,2016
4348,Avery Bradley,25,76,72,2536,456,1019,0.447,147,407,0.361,309,612,0.505,0.520,96,123,0.780,48,172,220,158,117,19,109,164,1155,BOS,2016
4349,Jae Crowder,25,73,73,2308,360,813,0.443,122,363,0.336,238,450,0.529,0.518,196,239,0.820,70,303,373,135,126,35,83,198,1038,BOS,2016
4350,Evan Turner,27,81,12,2271,343,753,0.456,20,83,0.241,323,670,0.482,0.469,148,179,0.827,50,347,397,359,80,28,169,139,854,BOS,2016
4351,Jared Sullinger,23,81,73,1915,351,806,0.435,29,103,0.282,322,703,0.458,0.453,103,161,0.640,194,479,673,187,75,47,102,209,834,BOS,2016
4352,Amir Johnson,28,79,76,1800,249,426,0.585,10,43,0.233,239,383,0.624,0.596,69,121,0.570,178,327,505,138,52,83,94,214,577,BOS,2016
4353,Marcus Smart,21,61,10,1667,184,529,0.348,61,241,0.253,123,288,0.427,0.405,129,166,0.777,76,179,255,185,91,18,80,183,558,BOS,2016
4354,Kelly Olynyk,24,69,8,1395,253,556,0.455,85,210,0.405,168,346,0.486,0.531,96,128,0.750,72,209,281,105,52,33,74,163,687,BOS,2016
4355,Jonas Jerebko,28,78,0,1176,118,286,0.413,43,108,0.398,75,178,0.421,0.488,61,78,0.782,77,211,288,62,20,24,52,137,340,BOS,2016
4356,Tyler Zeller,26,60,3,710,138,290,0.476,0,0,,138,290,0.476,0.476,88,108,0.815,62,116,178,29,10,22,46,97,364,BOS,2016
4357,David Lee,32,30,4,470,87,192,0.453,0,1,0.000,87,191,0.455,0.453,40,51,0.784,41,89,130,54,12,13,38,51,214,BOS,2016
4358,R.J. Hunter,22,36,0,315,36,98,0.367,19,63,0.302,17,35,0.486,0.464,6,7,0.857,2,35,37,13,14,4,11,29,97,BOS,2016
4359,Terry Rozier,21,39,0,311,29,106,0.274,6,27,0.222,23,79,0.291,0.302,8,10,0.800,24,39,63,37,6,1,19,23,72,BOS,2016
4360,James Young,20,29,0,199,11,36,0.306,6,26,0.231,5,10,0.500,0.389,1,4,0.250,4,22,26,9,6,1,5,17,29,BOS,2016
4361,Jordan Mickey,21,16,0,57,8,22,0.364,0,0,,8,22,0.364,0.364,5,10,0.500,6,7,13,1,0,11,1,5,21,BOS,2016
4362,Coty Clarke,23,3,0,6,2,4,0.500,2,2,1.000,0,2,0.000,0.750,0,0,,0,1,1,0,0,0,1,0,6,BOS,2016
4363,Carmelo Anthony,31,72,72,2530,567,1307,0.434,105,310,0.339,462,997,0.463,0.474,334,403,0.829,98,458,556,299,62,38,176,180,1573,NYK,2016
4364,Arron Afflalo,30,71,57,2371,354,799,0.443,91,238,0.382,263,561,0.469,0.500,110,131,0.840,23,243,266,144,25,10,82,142,909,NYK,2016
4365,Robin Lopez,27,82,82,2219,357,662,0.539,0,1,0.000,357,661,0.540,0.539,128,161,0.795,268,334,602,114,16,129,133,182,842,NYK,2016
4366,Kristaps Porziņģis,20,72,72,2047,373,886,0.421,81,243,0.333,292,643,0.454,0.467,201,240,0.838,132,394,526,94,53,134,121,205,1028,NYK,2016
4367,Langston Galloway,24,82,7,2033,231,588,0.393,77,224,0.344,154,364,0.423,0.458,86,114,0.754,43,245,288,207,77,22,61,177,625,NYK,2016
4368,José Calderón,34,72,72,2024,209,455,0.459,84,203,0.414,125,252,0.496,0.552,42,48,0.875,22,207,229,298,63,7,87,135,544,NYK,2016
4369,Derrick Williams,24,80,9,1435,254,565,0.450,44,150,0.293,210,415,0.506,0.488,194,256,0.758,47,249,296,75,29,9,61,69,746,NYK,2016
4370,Lance Thomas,27,59,5,1313,169,382,0.442,44,109,0.404,125,273,0.458,0.500,102,119,0.857,34,97,131,53,22,7,57,109,484,NYK,2016
4371,Jerian Grant,23,76,6,1265,154,391,0.394,22,100,0.220,132,291,0.454,0.422,96,123,0.780,23,120,143,177,50,10,87,97,426,NYK,2016
4372,Sasha Vujačić,31,61,25,908,106,277,0.383,52,143,0.364,54,134,0.403,0.477,32,39,0.821,26,123,149,84,34,5,44,83,296,NYK,2016
4373,Kyle O'Quinn,25,65,1,764,129,271,0.476,5,22,0.227,124,249,0.498,0.485,46,60,0.767,76,174,250,72,20,49,61,107,309,NYK,2016
4374,Kevin Séraphin,26,48,0,526,84,205,0.410,0,2,0.000,84,203,0.414,0.410,19,23,0.826,31,95,126,47,8,36,43,67,187,NYK,2016
4375,Lou Amundson,33,29,0,204,19,53,0.358,0,0,,19,53,0.358,0.358,14,27,0.519,23,26,49,12,6,7,15,44,52,NYK,2016
4376,Cleanthony Early,24,17,2,154,12,40,0.300,4,15,0.267,8,25,0.320,0.350,3,4,0.750,4,22,26,6,2,3,9,16,31,NYK,2016
4377,Thanasis Antetokounmpo,23,2,0,6,3,4,0.750,0,1,0.000,3,3,1.000,0.750,0,0,,0,1,1,0,0,0,0,2,6,NYK,2016
4378,Jimmer Fredette,26,2,0,5,1,1,1.000,1,1,1.000,0,0,,1.500,4,5,0.800,0,0,0,0,0,0,1,1,7,NYK,2016
4379,Brook Lopez,27,73,73,2457,591,1157,0.511,2,14,0.143,589,1143,0.515,0.512,317,403,0.787,204,369,573,147,58,124,175,215,1501,BRK,2016
4380,Thaddeus Young,27,73,73,2407,495,963,0.514,7,30,0.233,488,933,0.523,0.518,105,163,0.644,176,484,660,136,112,37,136,182,1102,BRK,2016
4381,Bojan Bogdanović,26,79,39,2115,324,749,0.433,129,338,0.382,195,411,0.474,0.519,110,132,0.833,36,219,255,99,29,5,115,119,887,BRK,2016
4382,Joe Johnson,34,57,57,1934,247,608,0.406,85,229,0.371,162,379,0.427,0.476,92,108,0.852,34,190,224,232,40,2,116,100,671,BRK,2016
4383,Shane Larkin,23,78,17,1751,222,502,0.442,39,108,0.361,183,394,0.464,0.481,83,107,0.776,28,152,180,342,95,12,146,121,566,BRK,2016
4384,Wayne Ellington,28,76,41,1615,218,561,0.389,96,268,0.358,122,293,0.416,0.474,54,63,0.857,20,154,174,83,48,5,45,82,586,BRK,2016
4385,Donald Sloan,28,61,33,1318,154,350,0.440,38,99,0.384,116,251,0.462,0.494,78,104,0.750,17,156,173,268,32,4,80,73,424,BRK,2016
4386,Jarrett Jack,32,32,32,1027,140,358,0.391,31,102,0.304,109,256,0.426,0.434,100,112,0.893,9,127,136,236,34,7,94,77,411,BRK,2016
4387,Markel Brown,24,62,6,982,127,322,0.394,38,121,0.314,89,201,0.443,0.453,71,94,0.755,23,99,122,91,38,15,54,94,363,BRK,2016
4388,Thomas Robinson,24,71,7,917,130,291,0.447,0,1,0.000,130,290,0.448,0.447,47,109,0.431,136,223,359,46,39,36,69,111,307,BRK,2016
4389,Andrea Bargnani,30,46,0,634,127,279,0.455,3,16,0.188,124,263,0.471,0.461,47,57,0.825,28,69,97,18,4,9,26,61,304,BRK,2016
4390,Rondae Hollis-Jefferson,21,29,17,615,63,138,0.457,4,14,0.286,59,124,0.476,0.471,37,52,0.712,39,115,154,43,39,16,26,61,167,BRK,2016
4391,Sean Kilpatrick,26,23,0,534,115,249,0.462,35,97,0.361,80,152,0.526,0.532,53,59,0.898,10,40,50,26,10,2,27,30,318,BRK,2016
4392,Willie Reed,25,39,2,426,76,133,0.571,0,0,,76,133,0.571,0.571,30,55,0.545,49,73,122,10,6,30,16,47,182,BRK,2016
4393,Sergey Karasev,22,40,5,399,30,74,0.405,11,37,0.297,19,37,0.514,0.480,26,28,0.929,8,50,58,35,6,2,22,27,97,BRK,2016
4394,Chris McCullough,20,24,4,362,44,109,0.404,13,34,0.382,31,75,0.413,0.463,11,23,0.478,25,43,68,9,28,12,15,39,112,BRK,2016
4395,Henry Sims,25,14,4,263,33,77,0.429,0,0,,33,77,0.429,0.429,25,30,0.833,21,51,72,9,9,14,12,37,91,BRK,2016
4396,Kyle Lowry,29,77,77,2851,512,1198,0.427,212,547,0.388,300,651,0.461,0.516,398,491,0.811,55,310,365,494,158,34,225,211,1634,TOR,2016
4397,DeMar DeRozan,26,78,78,2804,614,1377,0.446,47,139,0.338,567,1238,0.458,0.463,555,653,0.850,64,285,349,315,81,21,175,167,1830,TOR,2016
4398,Cory Joseph,24,80,4,2046,257,585,0.439,30,110,0.273,227,475,0.478,0.465,133,174,0.764,39,171,210,250,63,20,102,131,677,TOR,2016
4399,Patrick Patterson,26,79,0,2020,204,493,0.414,106,293,0.362,98,200,0.490,0.521,29,34,0.853,77,265,342,94,53,32,65,128,543,TOR,2016
4400,Bismack Biyombo,23,82,22,1808,156,288,0.542,0,1,0.000,156,287,0.544,0.542,142,226,0.628,182,473,655,29,19,133,71,225,454,TOR,2016
4401,Terrence Ross,24,73,7,1747,270,626,0.431,131,339,0.386,139,287,0.484,0.536,49,62,0.790,21,164,185,56,54,25,46,120,720,TOR,2016
4402,Luis Scola,35,76,76,1636,269,598,0.450,65,161,0.404,204,437,0.467,0.504,61,84,0.726,84,276,360,66,46,27,68,178,664,TOR,2016
4403,Jonas Valančiūnas,23,60,59,1557,303,536,0.565,0,0,,303,536,0.565,0.565,162,213,0.761,184,363,547,42,25,80,85,158,768,TOR,2016
4404,James Johnson,28,57,32,926,114,240,0.475,20,66,0.303,94,174,0.540,0.517,39,68,0.574,28,98,126,67,29,33,54,84,287,TOR,2016
4405,DeMarre Carroll,29,26,22,786,105,270,0.389,46,118,0.390,59,152,0.388,0.474,30,50,0.600,31,91,122,27,44,6,28,63,286,TOR,2016
4406,Norman Powell,22,49,24,725,97,229,0.424,36,89,0.404,61,140,0.436,0.502,43,53,0.811,16,95,111,47,29,10,32,59,273,TOR,2016
4407,Jason Thompson,29,19,6,292,32,66,0.485,5,15,0.333,27,51,0.529,0.523,18,22,0.818,22,58,80,10,8,12,8,40,87,TOR,2016
4408,Delon Wright,23,27,1,229,36,80,0.450,5,13,0.385,31,67,0.463,0.481,26,35,0.743,8,29,37,31,8,3,16,7,103,TOR,2016
4409,Lucas Nogueira,23,29,1,225,28,44,0.636,1,3,0.333,27,41,0.659,0.648,8,15,0.533,18,28,46,7,12,12,11,29,65,TOR,2016
4410,Anthony Bennett,22,19,0,84,8,27,0.296,3,14,0.214,5,13,0.385,0.352,9,10,0.900,6,17,23,0,5,0,4,8,28,TOR,2016
3769,James Harden,27,81,81,2947,674,1533,0.440,262,756,0.347,412,777,0.530,0.525,746,881,0.847,95,564,659,907,121,38,464,215,2356,HOU,2017
3770,Trevor Ariza,31,80,80,2773,326,798,0.409,191,555,0.344,135,243,0.556,0.528,93,126,0.738,54,404,458,175,147,20,73,133,936,HOU,2017
3771,Eric Gordon,28,75,15,2323,412,1016,0.406,246,661,0.372,166,355,0.468,0.527,147,175,0.840,29,172,201,188,48,41,121,150,1217,HOU,2017
3772,Ryan Anderson,28,72,72,2116,323,773,0.418,204,506,0.403,119,267,0.446,0.550,129,150,0.860,112,218,330,68,31,14,55,142,979,HOU,2017
3773,Patrick Beverley,28,67,67,2058,228,543,0.420,110,288,0.382,118,255,0.463,0.521,73,95,0.768,95,298,393,281,99,25,100,222,639,HOU,2017
3774,Clint Capela,22,65,59,1551,362,563,0.643,0,0,,362,563,0.643,0.643,94,177,0.531,178,348,526,63,34,79,87,179,818,HOU,2017
3775,Sam Dekker,22,77,2,1419,203,429,0.473,60,187,0.321,143,242,0.591,0.543,38,68,0.559,94,190,284,76,38,21,41,83,504,HOU,2017
3776,Nenê,34,67,8,1198,245,397,0.617,3,9,0.333,242,388,0.624,0.621,116,197,0.589,95,187,282,65,56,39,73,163,609,HOU,2017
3777,Montrezl Harrell,23,58,14,1064,225,345,0.652,1,7,0.143,224,338,0.663,0.654,76,121,0.628,81,138,219,64,20,42,44,126,527,HOU,2017
3778,Corey Brewer,30,58,8,923,94,227,0.414,22,94,0.234,72,133,0.541,0.463,32,44,0.727,21,93,114,61,37,12,36,104,242,HOU,2017
3779,Lou Williams,30,23,0,591,102,264,0.386,41,129,0.318,61,135,0.452,0.464,98,113,0.867,12,58,70,56,15,9,40,25,343,HOU,2017
3780,K.J. McDaniels,23,29,0,212,31,68,0.456,9,27,0.333,22,41,0.537,0.522,9,10,0.900,6,24,30,4,7,8,10,24,80,HOU,2017
3781,Tyler Ennis,22,31,0,196,25,64,0.391,6,16,0.375,19,48,0.396,0.438,2,3,0.667,4,15,19,34,6,0,24,29,58,HOU,2017
3782,Troy Williams,22,6,3,139,22,44,0.500,8,21,0.381,14,23,0.609,0.591,6,7,0.857,9,15,24,6,3,1,6,18,58,HOU,2017
3783,Bobby Brown,32,25,0,123,23,60,0.383,14,35,0.400,9,25,0.360,0.500,2,2,1.000,0,6,6,14,1,0,5,5,62,HOU,2017
3784,Chinanu Onuaku,20,5,1,52,5,7,0.714,0,0,,5,7,0.714,0.714,4,4,1.000,2,8,10,3,3,1,4,6,14,HOU,2017
3785,Isaiah Taylor,22,4,0,52,1,7,0.143,0,2,0.000,1,5,0.200,0.143,1,2,0.500,1,2,3,3,1,1,0,6,3,HOU,2017
3786,Kyle Wiltjer,24,14,0,44,4,14,0.286,4,13,0.308,0,1,0.000,0.429,1,2,0.500,4,6,10,2,3,1,5,4,13,HOU,2017
3787,Nik Stauskas,23,80,27,2188,251,634,0.396,132,359,0.368,119,275,0.433,0.500,122,150,0.813,21,205,226,188,45,32,128,144,756,PHI,2017
3788,T.J. McConnell,24,81,51,2133,236,512,0.461,11,55,0.200,225,457,0.492,0.472,73,90,0.811,39,212,251,534,134,10,159,139,556,PHI,2017
3789,Dario Šarić,22,81,36,2129,381,927,0.411,106,341,0.311,275,586,0.469,0.468,172,220,0.782,112,401,513,182,57,30,183,162,1040,PHI,2017
3790,Robert Covington,26,67,67,2119,292,732,0.399,137,412,0.333,155,320,0.484,0.492,143,174,0.822,92,344,436,102,127,69,131,203,864,PHI,2017
3791,Gerald Henderson,29,72,41,1667,234,553,0.423,61,173,0.353,173,380,0.455,0.478,133,165,0.806,34,151,185,112,40,15,62,129,662,PHI,2017
3792,Sergio Rodríguez,30,68,30,1518,210,536,0.392,92,252,0.365,118,284,0.415,0.478,18,27,0.667,21,136,157,344,49,4,128,95,530,PHI,2017
3793,Ersan İlyasova,29,53,40,1447,285,648,0.440,107,298,0.359,178,350,0.509,0.522,109,142,0.768,71,243,314,97,33,14,78,133,786,PHI,2017
3794,Richaun Holmes,23,57,17,1193,230,412,0.558,27,77,0.351,203,335,0.606,0.591,72,103,0.699,94,217,311,58,42,55,55,136,559,PHI,2017
3795,Timothé Luwawu-Cabarrot,21,69,19,1190,145,361,0.402,50,161,0.311,95,200,0.475,0.471,105,123,0.854,25,124,149,75,32,10,73,154,445,PHI,2017
3796,Jahlil Okafor,21,50,33,1134,242,471,0.514,0,0,,242,471,0.514,0.514,106,158,0.671,81,159,240,58,20,49,91,122,590,PHI,2017
3797,Joel Embiid,22,31,31,786,200,429,0.466,36,98,0.367,164,331,0.495,0.508,191,244,0.783,61,182,243,66,27,76,117,112,627,PHI,2017
3798,Nerlens Noel,22,29,7,564,107,175,0.611,0,1,0.000,107,174,0.615,0.611,43,63,0.683,46,98,144,30,43,26,29,71,257,PHI,2017
3799,Hollis Thompson,25,31,1,561,66,159,0.415,26,71,0.366,40,88,0.455,0.497,13,20,0.650,15,69,84,26,14,6,9,55,171,PHI,2017
3800,Justin Anderson,23,24,8,518,75,162,0.463,21,72,0.292,54,90,0.600,0.528,32,41,0.780,30,66,96,34,13,7,26,45,203,PHI,2017
3801,Shawn Long,24,18,0,234,61,109,0.560,7,19,0.368,54,90,0.600,0.592,19,35,0.543,41,44,85,13,9,9,13,49,148,PHI,2017
3802,Alex Poythress,23,6,1,157,25,54,0.463,6,19,0.316,19,35,0.543,0.519,8,10,0.800,11,18,29,5,3,2,3,14,64,PHI,2017
3803,Tiago Splitter,32,8,0,76,14,31,0.452,2,6,0.333,12,25,0.480,0.484,9,11,0.818,8,14,22,4,1,1,6,8,39,PHI,2017
3804,Chasson Randle,23,8,0,74,12,26,0.462,6,15,0.400,6,11,0.545,0.577,12,12,1.000,0,5,5,6,3,1,3,11,42,PHI,2017
3805,Jerryd Bayless,28,3,1,71,11,32,0.344,2,5,0.400,9,27,0.333,0.375,9,10,0.900,3,9,12,13,0,0,9,4,33,PHI,2017
3806,Jerami Grant,22,2,0,41,6,17,0.353,0,2,0.000,6,15,0.400,0.353,4,8,0.500,0,6,6,0,0,4,3,5,16,PHI,2017
3807,Justin Harper,27,3,0,31,5,12,0.417,2,7,0.286,3,5,0.600,0.500,0,0,,2,3,5,2,0,0,4,2,12,PHI,2017
3808,Isaiah Thomas,27,76,76,2569,682,1473,0.463,245,646,0.379,437,827,0.528,0.546,590,649,0.909,43,162,205,448,70,13,210,167,2199,BOS,2017
3809,Marcus Smart,22,79,24,2399,269,749,0.359,94,332,0.283,175,417,0.420,0.422,203,250,0.812,78,227,305,364,125,34,159,192,835,BOS,2017
3810,Jae Crowder,26,72,72,2335,333,720,0.463,157,394,0.398,176,326,0.540,0.572,176,217,0.811,48,367,415,155,73,23,80,161,999,BOS,2017
3811,Al Horford,30,68,68,2193,379,801,0.473,86,242,0.355,293,559,0.524,0.527,108,135,0.800,95,370,465,337,52,86,115,138,952,BOS,2017
3812,Avery Bradley,26,55,55,1835,359,775,0.463,108,277,0.390,251,498,0.504,0.533,68,93,0.731,65,269,334,122,68,11,88,141,894,BOS,2017
3813,Amir Johnson,29,80,77,1608,213,370,0.576,27,66,0.409,186,304,0.612,0.612,67,100,0.670,118,248,366,140,51,62,77,211,520,BOS,2017
3814,Kelly Olynyk,25,75,6,1538,260,508,0.512,68,192,0.354,192,316,0.608,0.579,90,123,0.732,73,288,361,148,43,29,96,207,678,BOS,2017
3815,Jaylen Brown,20,78,20,1341,192,423,0.454,46,135,0.341,146,288,0.507,0.508,85,124,0.685,45,175,220,64,35,18,68,142,515,BOS,2017
3816,Terry Rozier,22,74,0,1263,151,411,0.367,57,179,0.318,94,232,0.405,0.437,51,66,0.773,40,187,227,131,46,11,47,69,410,BOS,2017
3817,Jonas Jerebko,29,78,6,1232,114,262,0.435,45,130,0.346,69,132,0.523,0.521,26,37,0.703,59,213,272,71,25,17,39,122,299,BOS,2017
3818,Gerald Green,31,47,0,538,95,232,0.409,39,111,0.351,56,121,0.463,0.494,33,41,0.805,16,68,84,33,9,7,25,48,262,BOS,2017
3819,Tyler Zeller,27,51,5,525,78,158,0.494,0,1,0.000,78,157,0.497,0.494,22,39,0.564,43,81,124,42,7,21,20,61,178,BOS,2017
3820,James Young,21,29,0,220,25,58,0.431,12,35,0.343,13,23,0.565,0.534,6,9,0.667,6,20,26,4,10,2,4,15,68,BOS,2017
3821,Jordan Mickey,22,25,1,141,15,34,0.441,0,1,0.000,15,33,0.455,0.441,8,14,0.571,13,21,34,7,3,6,9,12,38,BOS,2017
3822,Demetrius Jackson,22,5,0,17,3,4,0.750,1,1,1.000,2,3,0.667,0.875,3,6,0.500,2,2,4,3,0,0,0,0,10,BOS,2017
3823,Carmelo Anthony,32,74,74,2538,602,1389,0.433,151,421,0.359,451,968,0.466,0.488,304,365,0.833,62,376,438,213,60,34,153,198,1659,NYK,2017
3824,Courtney Lee,31,77,74,2459,321,704,0.456,108,269,0.401,213,435,0.490,0.533,85,98,0.867,53,206,259,179,81,24,69,141,835,NYK,2017
3825,Kristaps Porziņģis,21,66,65,2164,443,985,0.450,112,314,0.357,331,671,0.493,0.507,198,252,0.786,111,364,475,97,47,129,118,244,1196,NYK,2017
3826,Derrick Rose,28,64,64,2082,460,977,0.471,13,60,0.217,447,917,0.487,0.477,221,253,0.874,66,180,246,283,44,17,147,84,1154,NYK,2017
3827,Justin Holiday,27,82,4,1639,233,538,0.433,97,273,0.355,136,265,0.513,0.523,66,80,0.825,27,198,225,102,65,31,66,109,629,NYK,2017
3828,Brandon Jennings,27,58,11,1428,163,429,0.380,68,200,0.340,95,229,0.415,0.459,102,135,0.756,21,131,152,287,55,4,106,84,496,NYK,2017
3829,Willy Hernangómez,22,72,22,1324,246,465,0.529,4,15,0.267,242,450,0.538,0.533,91,125,0.728,170,332,502,96,41,36,100,150,587,NYK,2017
3830,Kyle O'Quinn,26,79,8,1229,215,413,0.521,2,17,0.118,213,396,0.538,0.523,64,83,0.771,157,282,439,117,36,104,76,174,496,NYK,2017
3831,Mindaugas Kuzminskas,27,68,5,1016,158,369,0.428,54,168,0.321,104,201,0.517,0.501,55,68,0.809,47,79,126,69,29,11,51,79,425,NYK,2017
3832,Joakim Noah,31,46,46,1015,99,202,0.490,0,1,0.000,99,201,0.493,0.490,34,78,0.436,162,241,403,103,30,37,58,127,232,NYK,2017
3833,Lance Thomas,28,46,15,968,97,244,0.398,38,85,0.447,59,159,0.371,0.475,43,51,0.843,32,110,142,35,21,5,25,85,275,NYK,2017
3834,Ron Baker,23,52,13,857,82,217,0.378,23,86,0.267,59,131,0.450,0.431,28,43,0.651,12,86,98,107,34,8,56,74,215,NYK,2017
3835,Sasha Vujačić,32,42,4,408,42,136,0.309,23,74,0.311,19,62,0.306,0.393,17,24,0.708,12,47,59,52,13,2,16,38,124,NYK,2017
3836,Maurice Ndour,24,32,4,331,39,86,0.453,1,7,0.143,38,79,0.481,0.459,19,26,0.731,22,42,64,8,15,8,12,30,98,NYK,2017
3837,Chasson Randle,23,18,0,225,28,72,0.389,10,32,0.313,18,40,0.450,0.458,29,31,0.935,6,21,27,28,6,1,16,28,95,NYK,2017
3838,Marshall Plumlee,24,21,1,170,16,30,0.533,0,0,,16,30,0.533,0.533,8,19,0.421,23,28,51,10,4,4,12,23,40,NYK,2017
3839,Brook Lopez,28,75,75,2222,555,1172,0.474,134,387,0.346,421,785,0.536,0.531,295,364,0.810,121,282,403,176,38,124,184,192,1539,BRK,2017
3840,Rondae Hollis-Jefferson,22,78,50,1761,235,542,0.434,15,67,0.224,220,475,0.463,0.447,190,253,0.751,96,356,452,154,82,44,116,177,675,BRK,2017
3841,Sean Kilpatrick,27,70,24,1754,305,735,0.415,105,308,0.341,200,427,0.468,0.486,204,242,0.843,22,258,280,157,45,6,135,118,919,BRK,2017
3842,Trevor Booker,29,71,43,1754,305,591,0.516,25,78,0.321,280,513,0.546,0.537,74,110,0.673,143,428,571,138,75,28,127,152,709,BRK,2017
3843,Isaiah Whitehead,21,73,26,1643,204,508,0.402,44,149,0.295,160,359,0.446,0.445,91,113,0.805,32,152,184,192,42,36,142,175,543,BRK,2017
3844,Bojan Bogdanović,27,55,54,1482,269,611,0.440,99,277,0.357,170,334,0.509,0.521,146,167,0.874,23,174,197,90,24,3,93,99,783,BRK,2017
3845,Spencer Dinwiddie,23,59,18,1334,134,302,0.444,38,101,0.376,96,201,0.478,0.507,126,159,0.792,27,137,164,185,44,23,66,119,432,BRK,2017
3846,Randy Foye,33,69,40,1284,118,325,0.363,67,203,0.330,51,122,0.418,0.466,54,63,0.857,9,146,155,135,35,9,80,99,357,BRK,2017
3847,Caris LeVert,22,57,26,1237,171,380,0.450,59,184,0.321,112,196,0.571,0.528,67,93,0.720,23,165,188,110,49,8,59,91,468,BRK,2017
3848,Justin Hamilton,26,64,7,1177,174,379,0.459,55,180,0.306,119,199,0.598,0.532,39,52,0.750,71,191,262,55,29,43,43,91,442,BRK,2017
3849,Joe Harris,25,52,11,1138,154,362,0.425,85,221,0.385,69,141,0.489,0.543,35,49,0.714,16,131,147,54,30,8,55,121,428,BRK,2017
3850,Jeremy Lin,28,36,33,883,175,400,0.438,58,156,0.372,117,244,0.480,0.510,115,141,0.816,11,124,135,184,42,14,86,79,523,BRK,2017
3851,Quincy Acy,26,32,1,510,65,153,0.425,36,83,0.434,29,70,0.414,0.542,43,57,0.754,18,89,107,18,14,15,19,58,209,BRK,2017
3852,Luis Scola,36,36,1,461,71,151,0.470,17,50,0.340,54,101,0.535,0.526,25,37,0.676,51,88,139,37,14,4,34,63,184,BRK,2017
3853,K.J. McDaniels,23,20,0,293,46,101,0.455,11,39,0.282,35,62,0.565,0.510,23,28,0.821,9,43,52,9,12,10,19,25,126,BRK,2017
3854,Anthony Bennett,23,23,1,264,38,92,0.413,13,48,0.271,25,44,0.568,0.484,26,36,0.722,25,53,78,12,5,3,12,18,115,BRK,2017
3855,Archie Goodwin,22,12,0,184,34,61,0.557,4,13,0.308,30,48,0.625,0.590,23,32,0.719,7,21,28,23,4,4,14,7,95,BRK,2017
3856,Yogi Ferrell,23,10,0,151,18,49,0.367,8,27,0.296,10,22,0.455,0.449,10,16,0.625,4,8,12,17,2,2,14,11,54,BRK,2017
3857,Andrew Nicholson,27,10,0,111,13,34,0.382,2,11,0.182,11,23,0.478,0.412,2,2,1.000,4,23,27,3,5,0,6,18,30,BRK,2017
3858,Chris McCullough,21,14,0,72,16,31,0.516,1,6,0.167,15,25,0.600,0.532,2,3,0.667,9,8,17,2,1,2,2,7,35,BRK,2017
3859,Greivis Vásquez,30,3,0,39,2,8,0.250,1,3,0.333,1,5,0.200,0.313,2,3,0.667,0,2,2,5,1,1,1,6,7,BRK,2017
3860,DeMar DeRozan,27,74,74,2620,721,1545,0.467,33,124,0.266,688,1421,0.484,0.477,545,647,0.842,70,316,386,290,78,13,180,134,2020,TOR,2017
3861,Kyle Lowry,30,60,60,2244,426,918,0.464,193,468,0.412,233,450,0.518,0.569,299,365,0.819,48,238,286,417,88,19,173,170,1344,TOR,2017
3862,Jonas Valančiūnas,24,80,80,2066,391,702,0.557,1,2,0.500,390,700,0.557,0.558,176,217,0.811,226,533,759,57,37,63,106,216,959,TOR,2017
3863,Cory Joseph,25,80,22,2003,299,661,0.452,48,135,0.356,251,526,0.477,0.489,94,122,0.770,51,184,235,265,66,13,108,140,740,TOR,2017
3864,DeMarre Carroll,30,72,72,1882,220,550,0.400,109,320,0.341,111,230,0.483,0.499,89,117,0.761,63,212,275,74,81,27,54,143,638,TOR,2017
3865,Patrick Patterson,27,65,8,1599,154,384,0.401,94,253,0.372,60,131,0.458,0.523,43,60,0.717,62,231,293,76,40,23,38,120,445,TOR,2017
3866,Norman Powell,23,76,18,1368,227,506,0.449,56,173,0.324,171,333,0.514,0.504,126,159,0.792,26,143,169,82,52,14,70,127,636,TOR,2017
3867,Terrence Ross,25,54,0,1207,211,479,0.441,96,256,0.375,115,223,0.516,0.541,41,50,0.820,14,124,138,45,53,20,33,82,559,TOR,2017
3868,Lucas Nogueira,24,57,6,1088,103,156,0.660,3,12,0.250,100,144,0.694,0.670,44,67,0.657,82,162,244,42,52,89,46,137,253,TOR,2017
3550,Ben Moore,22,2,0,9,0,0,,0,0,,0,0,,,0,0,,0,1,1,1,0,0,0,4,0,IND,2018
3164,James Harden,28,72,72,2551,651,1449,0.449,265,722,0.367,386,727,0.531,0.541,624,727,0.858,41,348,389,630,126,50,315,169,2191,HOU,2018
3165,P.J. Tucker,32,82,34,2281,172,441,0.390,115,310,0.371,57,131,0.435,0.520,43,60,0.717,93,364,457,77,78,26,74,205,502,HOU,2018
3166,Trevor Ariza,32,67,67,2269,268,651,0.412,170,462,0.368,98,189,0.519,0.542,76,89,0.854,33,261,294,105,98,13,52,132,782,HOU,2018
3167,Eric Gordon,29,69,30,2154,415,970,0.428,218,608,0.359,197,362,0.544,0.540,195,241,0.809,25,145,170,154,44,27,130,116,1243,HOU,2018
3168,Clint Capela,23,74,74,2034,441,676,0.652,0,1,0.000,441,675,0.653,0.652,144,257,0.560,241,561,802,68,58,137,103,185,1026,HOU,2018
3169,Chris Paul,32,58,58,1847,367,798,0.460,144,379,0.380,223,419,0.532,0.550,203,221,0.919,37,276,313,457,96,14,128,141,1081,HOU,2018
3170,Ryan Anderson,29,66,50,1725,207,480,0.431,131,339,0.386,76,141,0.539,0.568,72,93,0.774,94,237,331,60,24,21,42,126,617,HOU,2018
3171,Luc Mbah a Moute,31,61,15,1564,166,345,0.481,63,173,0.364,103,172,0.599,0.572,65,95,0.684,22,164,186,55,72,25,68,100,460,HOU,2018
3172,Gerald Green,32,41,2,929,168,413,0.407,110,298,0.369,58,115,0.504,0.540,51,60,0.850,15,118,133,25,24,15,31,87,497,HOU,2018
3173,Nenê,35,52,4,758,136,239,0.569,0,2,0.000,136,237,0.574,0.569,68,107,0.636,54,122,176,45,28,14,38,123,340,HOU,2018
3174,Tarik Black,26,51,2,536,75,127,0.591,1,11,0.091,74,116,0.638,0.594,29,63,0.460,63,100,163,13,21,30,35,107,180,HOU,2018
3175,Joe Johnson,36,23,1,505,51,134,0.381,17,61,0.279,34,73,0.466,0.444,20,21,0.952,2,63,65,38,6,1,18,35,139,HOU,2018
3176,Zhou Qi,22,18,0,124,6,32,0.188,2,19,0.105,4,13,0.308,0.219,8,12,0.667,6,16,22,2,2,14,10,14,22,HOU,2018
3177,Briante Weber,25,13,0,118,9,22,0.409,4,9,0.444,5,13,0.385,0.500,4,4,1.000,3,15,18,13,10,3,7,18,26,HOU,2018
3178,Bobby Brown,33,20,0,115,19,58,0.328,11,40,0.275,8,18,0.444,0.422,1,2,0.500,0,7,7,11,4,0,9,6,50,HOU,2018
3179,Demetrius Jackson,23,12,0,63,4,14,0.286,0,6,0.000,4,8,0.500,0.286,0,0,,4,7,11,5,4,1,9,6,8,HOU,2018
3180,R.J. Hunter,24,5,1,45,7,20,0.350,3,14,0.214,4,6,0.667,0.425,2,2,1.000,0,5,5,3,3,0,2,7,19,HOU,2018
3181,Aaron Jackson,31,1,0,35,3,9,0.333,1,4,0.250,2,5,0.400,0.389,1,2,0.500,2,1,3,1,0,0,1,4,8,HOU,2018
3182,Markel Brown,26,4,0,31,2,7,0.286,1,5,0.200,1,2,0.500,0.357,0,0,,1,4,5,2,0,0,2,6,5,HOU,2018
3183,Chinanu Onuaku,21,1,0,22,2,5,0.400,0,0,,2,5,0.400,0.400,0,0,,1,3,4,1,0,0,3,4,4,HOU,2018
3184,Troy Williams,23,4,0,17,2,9,0.222,0,5,0.000,2,4,0.500,0.222,1,3,0.333,1,3,4,1,1,0,1,2,5,HOU,2018
3185,Brandan Wright,30,1,0,15,2,3,0.667,0,0,,2,3,0.667,0.667,0,0,,1,1,2,0,0,1,0,3,4,HOU,2018
3186,Tim Quarterman,23,3,0,13,1,3,0.333,0,2,0.000,1,1,1.000,0.333,2,2,1.000,0,3,3,1,0,0,2,1,4,HOU,2018
3187,Isaiah Canaan,26,1,0,4,0,1,0.000,0,0,,0,1,0.000,0.000,0,0,,0,1,1,0,0,0,0,0,0,HOU,2018
3188,Ben Simmons,21,81,81,2732,544,998,0.545,0,11,0.000,544,987,0.551,0.545,191,341,0.560,145,514,659,661,140,70,278,211,1279,PHI,2018
3189,Robert Covington,27,80,80,2532,345,836,0.413,203,550,0.369,142,286,0.497,0.534,116,136,0.853,55,378,433,156,137,72,126,238,1009,PHI,2018
3190,Dario Šarić,23,78,73,2310,403,890,0.453,157,399,0.393,246,491,0.501,0.541,178,207,0.860,154,366,520,202,51,20,148,160,1141,PHI,2018
3191,J.J. Redick,33,70,70,2116,404,879,0.460,193,460,0.420,211,419,0.504,0.569,197,218,0.904,9,169,178,210,35,6,103,123,1198,PHI,2018
3192,Joel Embiid,23,63,63,1912,510,1056,0.483,66,214,0.308,444,842,0.527,0.514,359,467,0.769,143,547,690,199,40,111,234,209,1445,PHI,2018
3193,T.J. McConnell,25,76,1,1706,210,421,0.499,27,62,0.435,183,359,0.510,0.531,31,39,0.795,37,189,226,303,92,13,112,122,478,PHI,2018
3194,Amir Johnson,30,74,18,1171,140,260,0.538,10,32,0.313,130,228,0.570,0.558,52,85,0.612,123,207,330,118,45,44,55,192,342,PHI,2018
3195,Jerryd Bayless,29,39,11,925,109,262,0.416,54,146,0.370,55,116,0.474,0.519,35,44,0.795,15,65,80,54,23,6,46,91,307,PHI,2018
3196,Timothé Luwawu-Cabarrot,22,52,7,807,100,267,0.375,53,158,0.335,47,109,0.431,0.474,46,58,0.793,14,58,72,54,12,5,38,97,299,PHI,2018
3197,Richaun Holmes,24,48,2,746,135,241,0.560,4,31,0.129,131,210,0.624,0.568,37,56,0.661,57,154,211,61,20,29,25,97,311,PHI,2018
3198,Marco Belinelli,31,28,1,737,138,279,0.495,57,148,0.385,81,131,0.618,0.597,47,54,0.870,6,45,51,45,20,9,40,50,380,PHI,2018
3199,Ersan İlyasova,30,23,3,554,93,212,0.439,30,83,0.361,63,129,0.488,0.509,33,45,0.733,44,110,154,39,17,9,29,65,249,PHI,2018
3200,Justin Anderson,24,38,0,519,87,202,0.431,34,103,0.330,53,99,0.535,0.515,28,38,0.737,25,68,93,25,15,7,16,54,236,PHI,2018
3201,Trevor Booker,30,33,0,494,61,109,0.560,2,7,0.286,59,102,0.578,0.569,32,39,0.821,47,75,122,27,16,11,20,50,156,PHI,2018
3202,Markelle Fultz,19,14,0,253,45,111,0.405,0,1,0.000,45,110,0.409,0.405,10,21,0.476,11,32,43,53,12,4,17,22,100,PHI,2018
3203,Furkan Korkmaz,20,14,0,80,8,28,0.286,5,17,0.294,3,11,0.273,0.375,2,4,0.500,2,9,11,4,2,1,2,12,23,PHI,2018
3204,James Young,22,6,0,61,5,14,0.357,3,10,0.300,2,4,0.500,0.464,4,6,0.667,0,2,2,2,0,0,1,4,17,PHI,2018
3205,Nik Stauskas,24,6,0,45,1,4,0.250,0,1,0.000,1,3,0.333,0.250,2,2,1.000,0,1,1,1,4,0,4,3,4,PHI,2018
3206,Jahlil Okafor,22,2,0,25,4,9,0.444,0,0,,4,9,0.444,0.444,2,4,0.500,4,5,9,1,0,2,3,7,10,PHI,2018
3207,James Michael McAdoo,25,3,0,18,2,7,0.286,2,7,0.286,0,0,,0.429,2,2,1.000,0,2,2,0,0,1,1,1,8,PHI,2018
3208,Demetrius Jackson,23,3,0,17,3,4,0.750,1,1,1.000,2,3,0.667,0.875,1,2,0.500,1,0,1,4,1,0,1,1,8,PHI,2018
3209,Larry Drew II,27,3,0,15,1,7,0.143,0,3,0.000,1,4,0.250,0.143,0,0,,1,0,1,2,0,0,1,2,2,PHI,2018
3210,Jacob Pullen,28,3,0,6,1,2,0.500,0,1,0.000,1,1,1.000,0.500,0,0,,0,0,0,0,0,0,1,0,2,PHI,2018
3211,Jayson Tatum,19,80,80,2443,397,835,0.475,105,242,0.434,292,593,0.492,0.538,213,258,0.826,50,352,402,128,83,58,114,170,1112,BOS,2018
3212,Al Horford,31,72,72,2277,368,753,0.489,97,226,0.429,271,527,0.514,0.553,94,120,0.783,103,427,530,339,43,78,132,138,927,BOS,2018
3213,Jaylen Brown,21,70,70,2152,373,803,0.465,121,306,0.395,252,497,0.507,0.540,150,233,0.644,66,280,346,114,70,26,124,181,1017,BOS,2018
3214,Terry Rozier,23,80,16,2068,316,800,0.395,153,402,0.381,163,398,0.410,0.491,115,149,0.772,63,313,376,232,80,19,80,123,900,BOS,2018
3215,Kyrie Irving,25,60,60,1931,534,1087,0.491,166,407,0.408,368,680,0.541,0.568,232,261,0.889,33,194,227,306,65,17,140,122,1466,BOS,2018
3216,Marcus Smart,23,54,11,1614,189,515,0.367,75,249,0.301,114,266,0.429,0.440,97,133,0.729,43,146,189,259,71,23,129,133,550,BOS,2018
3217,Aron Baynes,31,81,67,1485,210,446,0.471,3,21,0.143,207,425,0.487,0.474,59,78,0.756,130,304,434,93,22,51,80,200,482,BOS,2018
3218,Marcus Morris,28,54,21,1442,262,611,0.429,86,234,0.368,176,377,0.467,0.499,124,154,0.805,43,246,289,72,35,12,65,100,734,BOS,2018
3219,Semi Ojeleye,23,73,0,1150,65,188,0.346,40,125,0.320,25,63,0.397,0.452,25,41,0.610,37,124,161,20,21,4,25,91,195,BOS,2018
3220,Daniel Theis,25,63,3,936,126,233,0.541,18,58,0.310,108,175,0.617,0.579,61,81,0.753,90,184,274,56,30,48,56,157,331,BOS,2018
3221,Shane Larkin,25,54,2,775,84,219,0.384,31,86,0.360,53,133,0.398,0.454,32,37,0.865,15,77,92,98,29,2,33,58,231,BOS,2018
3222,Abdel Nader,24,48,1,522,50,149,0.336,23,65,0.354,27,84,0.321,0.413,23,39,0.590,13,58,71,26,15,10,34,45,146,BOS,2018
3223,Greg Monroe,27,26,0,496,105,198,0.530,0,0,,105,198,0.530,0.530,55,69,0.797,53,112,165,59,28,17,48,48,265,BOS,2018
3224,Guerschon Yabusele,22,33,4,235,26,61,0.426,12,37,0.324,14,24,0.583,0.525,15,22,0.682,17,35,52,16,4,5,12,23,79,BOS,2018
3225,Jabari Bird,23,13,1,115,15,26,0.577,3,7,0.429,12,19,0.632,0.635,6,13,0.462,6,13,19,8,3,1,8,7,39,BOS,2018
3226,Kadeem Allen,25,18,1,107,6,22,0.273,0,11,0.000,6,11,0.545,0.273,7,9,0.778,4,7,11,12,3,2,9,15,19,BOS,2018
3227,Jonathan Gibson,30,4,0,40,14,23,0.609,6,12,0.500,8,11,0.727,0.739,0,0,,0,3,3,4,0,0,3,5,34,BOS,2018
3228,Xavier Silas,30,2,0,7,0,3,0.000,0,2,0.000,0,1,0.000,0.000,0,0,,1,1,2,0,1,0,0,1,0,BOS,2018
3229,Jarell Eddie,26,2,0,6,0,1,0.000,0,1,0.000,0,0,,0.000,0,0,,0,1,1,0,1,0,0,0,0,BOS,2018
3230,Gordon Hayward,27,1,1,5,1,2,0.500,0,1,0.000,1,1,1.000,0.500,0,0,,0,1,1,0,0,0,0,1,2,BOS,2018
3231,Courtney Lee,32,76,69,2310,343,755,0.454,113,278,0.406,230,477,0.482,0.529,114,124,0.919,30,194,224,180,80,17,84,109,913,NYK,2018
3232,Tim Hardaway Jr.,25,57,54,1885,360,856,0.421,130,410,0.317,230,446,0.516,0.496,146,179,0.816,32,192,224,155,62,10,92,123,996,NYK,2018
3233,Enes Freedom,25,71,71,1830,422,713,0.592,0,2,0.000,422,711,0.594,0.592,156,184,0.848,273,507,780,105,36,37,122,187,1000,NYK,2018
3234,Frank Ntilikina,19,78,9,1706,182,500,0.364,50,157,0.318,132,343,0.385,0.414,49,68,0.721,37,140,177,250,65,18,131,181,463,NYK,2018
3235,Michael Beasley,29,74,30,1653,409,807,0.507,34,86,0.395,375,721,0.520,0.528,124,159,0.780,97,317,414,123,36,43,143,145,976,NYK,2018
3236,Kristaps Porziņģis,22,48,48,1553,390,889,0.439,90,228,0.395,300,661,0.454,0.489,218,275,0.793,62,254,316,57,36,115,93,141,1088,NYK,2018
3237,Jarrett Jack,34,62,56,1548,189,443,0.427,25,86,0.291,164,357,0.459,0.455,63,75,0.840,22,169,191,348,35,4,115,98,466,NYK,2018
3238,Kyle O'Quinn,27,77,10,1387,224,384,0.583,4,17,0.235,220,367,0.599,0.589,98,127,0.772,121,349,470,158,36,98,100,192,550,NYK,2018
3239,Lance Thomas,29,73,31,1353,102,267,0.382,50,124,0.403,52,143,0.364,0.476,44,53,0.830,44,131,175,44,30,14,40,134,298,NYK,2018
3240,Doug McDermott,26,55,1,1172,151,328,0.460,53,137,0.387,98,191,0.513,0.541,40,53,0.755,33,101,134,50,10,12,34,73,395,NYK,2018
3241,Trey Burke,25,36,9,785,193,384,0.503,38,105,0.362,155,279,0.556,0.552,37,57,0.649,13,58,71,170,24,4,43,43,461,NYK,2018
3242,Emmanuel Mudiay,21,22,14,493,75,204,0.368,9,46,0.196,66,158,0.418,0.390,35,51,0.686,10,48,58,85,20,7,41,33,194,NYK,2018
3243,Damyean Dotson,23,44,2,474,72,161,0.447,22,68,0.324,50,93,0.538,0.516,16,23,0.696,9,75,84,31,12,2,17,34,182,NYK,2018
3244,Ron Baker,24,29,1,385,20,59,0.339,11,33,0.333,9,26,0.346,0.432,20,26,0.769,5,25,30,47,26,6,18,33,71,NYK,2018
3245,Luke Kornet,22,20,1,326,49,125,0.392,28,79,0.354,21,46,0.457,0.504,8,11,0.727,11,53,64,26,6,16,12,28,134,NYK,2018
3246,Troy Williams,23,17,1,290,49,100,0.490,11,33,0.333,38,67,0.567,0.545,19,27,0.704,21,38,59,15,19,4,18,32,128,NYK,2018
3247,Isaiah Hicks,23,18,0,240,33,72,0.458,2,9,0.222,31,63,0.492,0.472,12,18,0.667,10,31,41,16,2,4,16,45,80,NYK,2018
3248,Willy Hernangómez,23,26,0,233,49,81,0.605,1,5,0.200,48,76,0.632,0.611,12,28,0.429,22,45,67,21,8,7,26,32,111,NYK,2018
3249,Ramon Sessions,31,13,3,167,17,53,0.321,2,11,0.182,15,42,0.357,0.340,12,15,0.800,1,17,18,27,7,1,15,14,48,NYK,2018
3250,Joakim Noah,32,7,0,40,5,10,0.500,0,0,,5,10,0.500,0.500,2,4,0.500,6,8,14,4,2,2,4,5,12,NYK,2018
3251,Mindaugas Kuzminskas,28,1,0,2,0,2,0.000,0,0,,0,2,0.000,0.000,0,0,,0,0,0,0,0,0,0,0,0,NYK,2018
3252,Spencer Dinwiddie,24,80,58,2306,324,838,0.387,141,433,0.326,183,405,0.452,0.471,218,268,0.813,40,219,259,524,68,23,128,186,1007,BRK,2018
3253,Allen Crabbe,25,75,68,2197,337,827,0.407,201,532,0.378,136,295,0.461,0.529,115,135,0.852,28,296,324,117,47,35,78,168,990,BRK,2018
3254,DeMarre Carroll,31,73,73,2180,325,785,0.414,145,391,0.371,180,394,0.457,0.506,188,246,0.764,105,374,479,147,59,30,103,165,983,BRK,2018
3255,Joe Harris,26,78,14,1975,305,621,0.491,150,358,0.419,155,263,0.589,0.612,86,104,0.827,51,209,260,128,35,20,91,153,846,BRK,2018
3256,Rondae Hollis-Jefferson,23,68,59,1920,342,724,0.472,13,54,0.241,329,670,0.491,0.481,249,316,0.788,101,358,459,167,65,48,121,145,946,BRK,2018
3257,Caris LeVert,23,71,10,1864,320,735,0.435,85,245,0.347,235,490,0.480,0.493,133,187,0.711,53,207,260,299,82,22,153,159,858,BRK,2018
3258,Jarrett Allen,19,72,31,1441,234,397,0.589,5,15,0.333,229,382,0.599,0.596,114,147,0.776,144,244,388,49,28,88,82,147,587,BRK,2018
3259,Quincy Acy,27,70,8,1359,130,365,0.356,102,292,0.349,28,73,0.384,0.496,49,60,0.817,40,217,257,57,33,29,60,149,411,BRK,2018
3260,D'Angelo Russell,21,48,35,1234,278,672,0.414,90,278,0.324,188,394,0.477,0.481,97,131,0.740,30,159,189,249,36,17,147,93,743,BRK,2018
3261,Tyler Zeller,28,42,33,703,125,229,0.546,10,26,0.385,115,203,0.567,0.568,40,60,0.667,63,131,194,28,8,21,35,78,300,BRK,2018
3262,Nik Stauskas,24,35,0,478,59,150,0.393,40,99,0.404,19,51,0.373,0.527,19,27,0.704,4,59,63,38,5,4,22,21,177,BRK,2018
2740,Ray Spalding,21,1,0,1,0,0,,0,0,,0,0,,,0,0,,0,0,0,0,0,0,0,0,0,DAL,2019
2542,James Harden,29,78,78,2867,843,1909,0.442,378,1028,0.368,465,881,0.528,0.541,754,858,0.879,66,452,518,586,158,58,387,244,2818,HOU,2019
2543,P.J. Tucker,33,82,82,2802,207,523,0.396,146,387,0.377,61,136,0.449,0.535,41,59,0.695,121,358,479,96,132,39,63,252,601,HOU,2019
2544,Clint Capela,24,67,67,2249,474,732,0.648,0,0,,474,732,0.648,0.648,166,261,0.636,298,550,848,96,44,102,94,168,1114,HOU,2019
2545,Eric Gordon,30,68,53,2158,384,938,0.409,216,600,0.360,168,338,0.497,0.525,119,152,0.783,17,131,148,129,41,27,90,143,1103,HOU,2019
2546,Chris Paul,33,58,58,1857,302,720,0.419,127,355,0.358,175,365,0.479,0.508,175,203,0.862,36,229,265,473,114,18,152,146,906,HOU,2019
2547,Gerald Green,33,73,0,1473,231,578,0.400,156,441,0.354,75,137,0.547,0.535,57,68,0.838,30,152,182,40,33,27,55,126,675,HOU,2019
2548,Austin Rivers,26,47,13,1345,156,378,0.413,71,221,0.321,85,157,0.541,0.507,25,49,0.510,15,76,91,109,29,13,32,135,408,HOU,2019
2549,Danuel House Jr.,25,39,13,979,118,252,0.468,74,178,0.416,44,74,0.595,0.615,56,71,0.789,25,115,140,40,21,11,35,80,366,HOU,2019
2550,James Ennis III,28,40,25,949,104,211,0.493,44,120,0.367,60,91,0.659,0.597,42,58,0.724,37,80,117,27,38,16,23,111,294,HOU,2019
2551,Gary Clark,24,51,2,641,50,151,0.331,41,138,0.297,9,13,0.692,0.467,7,7,1.000,24,92,116,18,20,26,7,47,148,HOU,2019
2552,Kenneth Faried,29,25,13,610,131,223,0.587,7,20,0.350,124,203,0.611,0.603,54,83,0.651,82,124,206,18,15,19,27,74,323,HOU,2019
2553,Nenê,36,42,2,546,60,116,0.517,0,3,0.000,60,113,0.531,0.517,31,47,0.660,34,89,123,26,18,15,11,87,151,HOU,2019
2554,Iman Shumpert,28,20,1,382,34,98,0.347,21,71,0.296,13,27,0.481,0.454,2,4,0.500,8,46,54,21,12,4,12,35,91,HOU,2019
2555,Carmelo Anthony,34,10,2,294,49,121,0.405,21,64,0.328,28,57,0.491,0.492,15,22,0.682,9,45,54,5,4,7,8,32,134,HOU,2019
2556,Isaiah Hartenstein,20,28,0,221,20,41,0.488,2,6,0.333,18,35,0.514,0.512,11,14,0.786,21,26,47,15,7,12,13,56,53,HOU,2019
2557,Michael Carter-Williams,27,16,1,145,25,61,0.410,7,19,0.368,18,42,0.429,0.467,12,26,0.462,3,10,13,21,9,6,10,27,69,HOU,2019
2558,Brandon Knight,27,12,0,118,11,47,0.234,5,32,0.156,6,15,0.400,0.287,9,11,0.818,1,8,9,9,2,0,5,14,36,HOU,2019
2559,Marquese Chriss,21,16,0,104,11,34,0.324,1,15,0.067,10,19,0.526,0.338,6,7,0.857,7,21,28,6,2,4,12,17,29,HOU,2019
2560,James Nunnally,28,2,0,38,3,13,0.231,3,12,0.250,0,1,0.000,0.346,0,0,,0,1,1,2,0,0,0,6,9,HOU,2019
2561,Chris Chiozza,23,7,0,33,2,8,0.250,2,5,0.400,0,3,0.000,0.375,0,0,,1,3,4,4,1,1,1,2,6,HOU,2019
2562,Vince Edwards,22,2,0,16,1,4,0.250,1,4,0.250,0,0,,0.375,0,0,,1,1,2,0,0,0,0,0,3,HOU,2019
2563,Terrence Jones,27,2,0,5,1,4,0.250,0,2,0.000,1,2,0.500,0.250,0,1,0.000,0,4,4,0,0,0,1,1,2,HOU,2019
2564,Zhou Qi,23,1,0,1,1,1,1.000,0,0,,1,1,1.000,1.000,0,0,,0,0,0,0,0,0,0,0,2,HOU,2019
2565,Ben Simmons,22,79,79,2700,540,960,0.563,0,6,0.000,540,954,0.566,0.563,257,428,0.600,172,525,697,610,112,61,274,209,1337,PHI,2019
2566,J.J. Redick,34,76,63,2379,452,1027,0.440,240,605,0.397,212,422,0.502,0.557,228,255,0.894,20,166,186,206,32,17,101,129,1372,PHI,2019
2567,Joel Embiid,24,64,64,2154,580,1199,0.484,79,263,0.300,501,936,0.535,0.517,522,649,0.804,160,711,871,234,46,122,226,211,1761,PHI,2019
2568,Jimmy Butler,29,55,55,1824,344,747,0.461,50,148,0.338,294,599,0.491,0.494,264,304,0.868,105,185,290,220,99,29,81,93,1002,PHI,2019
2569,T.J. McConnell,26,76,3,1470,220,419,0.525,14,42,0.333,206,377,0.546,0.542,29,37,0.784,28,146,174,258,79,17,91,105,483,PHI,2019
2570,Landry Shamet,21,54,4,1108,153,347,0.441,99,245,0.404,54,102,0.529,0.584,44,54,0.815,14,64,78,59,24,8,26,106,449,PHI,2019
2571,Mike Muscala,27,47,6,1041,109,278,0.392,68,199,0.342,41,79,0.519,0.514,63,77,0.818,51,149,200,62,18,27,43,112,349,PHI,2019
2572,Wilson Chandler,31,36,32,951,91,207,0.440,46,118,0.390,45,89,0.506,0.551,13,18,0.722,44,124,168,72,22,18,39,94,241,PHI,2019
2573,Tobias Harris,26,27,27,944,187,399,0.469,44,135,0.326,143,264,0.542,0.524,74,88,0.841,32,181,213,79,11,13,42,61,492,PHI,2019
2574,Furkan Korkmaz,21,48,7,679,98,245,0.400,47,144,0.326,51,101,0.505,0.496,36,44,0.818,16,91,107,52,29,2,25,62,279,PHI,2019
2575,Mike Scott,30,27,3,647,76,190,0.400,49,119,0.412,27,71,0.380,0.529,10,15,0.667,19,83,102,22,9,5,17,68,211,PHI,2019
2576,Jonah Bolden,23,44,10,639,80,162,0.494,34,96,0.354,46,66,0.697,0.599,13,27,0.481,47,118,165,40,17,39,36,99,207,PHI,2019
2577,Amir Johnson,31,51,6,529,79,157,0.503,12,40,0.300,67,117,0.573,0.541,31,41,0.756,47,100,147,60,16,13,45,99,201,PHI,2019
2578,Robert Covington,28,13,13,440,50,117,0.427,30,77,0.390,20,40,0.500,0.556,17,23,0.739,7,60,67,14,24,23,22,45,147,PHI,2019
2579,Markelle Fultz,20,19,15,427,65,155,0.419,4,14,0.286,61,141,0.433,0.432,21,37,0.568,26,44,70,59,17,5,25,52,155,PHI,2019
2580,Dario Šarić,24,13,13,396,48,132,0.364,21,70,0.300,27,62,0.435,0.443,27,30,0.900,21,65,86,26,4,3,25,39,144,PHI,2019
2581,Boban Marjanović,30,22,3,305,75,120,0.625,4,8,0.500,71,112,0.634,0.642,26,36,0.722,32,81,113,32,5,10,22,33,180,PHI,2019
2582,James Ennis III,28,18,2,281,34,83,0.410,11,36,0.306,23,47,0.489,0.476,16,23,0.696,23,42,65,14,3,7,11,39,95,PHI,2019
2583,Shake Milton,22,20,0,268,34,87,0.391,14,44,0.318,20,43,0.465,0.471,5,7,0.714,9,26,35,18,8,8,6,29,87,PHI,2019
2584,Jonathon Simmons,29,15,0,219,29,64,0.453,9,21,0.429,20,43,0.465,0.523,16,25,0.640,4,22,26,33,11,1,12,21,83,PHI,2019
2585,Corey Brewer,32,7,3,140,20,49,0.408,4,14,0.286,16,35,0.457,0.449,9,13,0.692,4,13,17,10,12,2,8,16,53,PHI,2019
2586,Zhaire Smith,19,6,2,111,14,34,0.412,6,16,0.375,8,18,0.444,0.500,6,8,0.750,3,10,13,10,2,2,6,8,40,PHI,2019
2587,Greg Monroe,28,3,0,52,15,23,0.652,1,1,1.000,14,22,0.636,0.674,10,11,0.909,4,9,13,7,1,0,1,5,41,PHI,2019
2588,Haywood Highsmith,22,5,0,40,4,10,0.400,1,5,0.200,3,5,0.600,0.450,0,2,0.000,0,5,5,2,1,0,1,1,9,PHI,2019
2589,Demetrius Jackson,24,6,0,39,8,15,0.533,2,6,0.333,6,9,0.667,0.600,4,4,1.000,2,1,3,5,2,0,1,4,22,PHI,2019
2590,Justin Patton,21,3,0,21,2,7,0.286,0,2,0.000,2,5,0.400,0.286,1,2,0.500,2,4,6,3,2,0,0,5,5,PHI,2019
2591,Jayson Tatum,20,79,79,2455,466,1036,0.450,116,311,0.373,350,725,0.483,0.506,195,228,0.855,70,407,477,168,84,57,122,168,1243,BOS,2019
2592,Kyrie Irving,26,67,67,2214,604,1241,0.487,174,434,0.401,430,807,0.533,0.557,214,245,0.873,71,264,335,464,103,34,172,167,1596,BOS,2019
2593,Marcus Smart,24,80,60,2200,239,567,0.422,126,346,0.364,113,221,0.511,0.533,104,129,0.806,57,177,234,321,143,28,123,201,708,BOS,2019
2594,Marcus Morris,29,75,53,2091,377,844,0.447,146,389,0.375,231,455,0.508,0.533,146,173,0.844,76,382,458,109,43,25,92,181,1046,BOS,2019
2595,Al Horford,32,68,68,1973,387,723,0.535,73,203,0.360,314,520,0.604,0.586,78,95,0.821,120,338,458,283,59,86,102,126,925,BOS,2019
2596,Jaylen Brown,22,74,25,1913,368,792,0.465,95,276,0.344,273,516,0.529,0.525,133,202,0.658,65,248,313,100,69,32,99,186,964,BOS,2019
2597,Gordon Hayward,28,72,18,1863,296,635,0.466,77,231,0.333,219,404,0.542,0.527,156,187,0.834,51,271,322,244,62,23,105,104,825,BOS,2019
2598,Terry Rozier,24,79,14,1791,258,666,0.387,119,337,0.353,139,329,0.422,0.477,73,93,0.785,32,275,307,231,68,21,68,101,708,BOS,2019
2599,Daniel Theis,26,66,2,908,146,266,0.549,26,67,0.388,120,199,0.603,0.598,56,76,0.737,87,138,225,68,21,42,33,161,374,BOS,2019
2600,Aron Baynes,32,51,18,821,105,223,0.471,21,61,0.344,84,162,0.519,0.518,53,62,0.855,88,152,240,57,12,34,40,125,284,BOS,2019
2601,Semi Ojeleye,24,56,3,594,67,158,0.424,28,89,0.315,39,69,0.565,0.513,24,39,0.615,24,62,86,23,10,4,19,43,186,BOS,2019
2602,Brad Wanamaker,29,36,0,343,50,105,0.476,16,39,0.410,34,66,0.515,0.552,24,28,0.857,3,38,41,56,12,2,19,34,140,BOS,2019
2603,Robert Williams,21,32,2,283,36,51,0.706,0,0,,36,51,0.706,0.706,9,15,0.600,27,54,81,7,9,40,10,36,81,BOS,2019
2604,Guerschon Yabusele,23,41,1,251,35,77,0.455,9,28,0.321,26,49,0.531,0.513,15,22,0.682,23,30,53,15,8,7,15,32,94,BOS,2019
2605,PJ Dozier,22,6,0,51,8,21,0.381,2,8,0.250,6,13,0.462,0.429,1,2,0.500,6,11,17,5,2,0,0,2,19,BOS,2019
2606,R.J. Hunter,25,1,0,26,6,13,0.462,4,10,0.400,2,3,0.667,0.615,1,2,0.500,1,2,3,3,1,0,0,3,17,BOS,2019
2607,Greg Monroe,28,2,0,5,3,5,0.600,0,0,,3,5,0.600,0.600,0,0,,3,0,3,1,0,0,0,0,6,BOS,2019
2608,Kevin Knox,19,75,57,2158,338,914,0.370,125,364,0.343,213,550,0.387,0.438,162,226,0.717,61,274,335,82,43,24,114,175,963,NYK,2019
2609,Damyean Dotson,24,73,40,2004,290,698,0.415,126,342,0.368,164,356,0.461,0.506,73,98,0.745,34,228,262,135,58,10,71,135,779,NYK,2019
2610,Noah Vonleh,23,68,57,1722,207,440,0.470,46,137,0.336,161,303,0.531,0.523,111,156,0.712,113,415,528,129,46,51,88,174,571,NYK,2019
2611,Emmanuel Mudiay,22,59,42,1607,330,740,0.446,69,210,0.329,261,530,0.492,0.493,144,186,0.774,33,163,196,228,43,19,140,103,873,NYK,2019
2612,Tim Hardaway Jr.,26,46,46,1499,282,726,0.388,117,337,0.347,165,389,0.424,0.469,199,233,0.854,26,135,161,122,42,6,81,106,880,NYK,2019
2613,Allonzo Trier,23,64,3,1459,232,518,0.448,52,132,0.394,180,386,0.466,0.498,179,223,0.803,31,166,197,119,28,14,116,117,695,NYK,2019
2614,Mitchell Robinson,20,66,19,1360,202,291,0.694,0,0,,202,291,0.694,0.694,81,135,0.600,177,246,423,37,52,161,35,217,485,NYK,2019
2615,Mario Hezonja,23,58,24,1206,191,464,0.412,42,152,0.276,149,312,0.478,0.457,87,114,0.763,28,211,239,88,57,8,88,110,511,NYK,2019
2616,Enes Freedom,26,44,23,1128,251,468,0.536,7,22,0.318,244,446,0.547,0.544,105,129,0.814,171,290,461,84,18,17,79,106,614,NYK,2019
2617,Frank Ntilikina,20,43,16,904,95,282,0.337,33,115,0.287,62,167,0.371,0.395,23,30,0.767,12,75,87,121,30,14,56,104,246,NYK,2019
2618,Luke Kornet,23,46,18,784,107,283,0.378,70,193,0.363,37,90,0.411,0.502,38,46,0.826,28,107,135,54,27,42,25,41,322,NYK,2019
2619,Lance Thomas,30,46,17,783,78,197,0.396,22,79,0.278,56,118,0.475,0.452,27,36,0.750,21,96,117,27,17,7,24,83,205,NYK,2019
2620,Trey Burke,26,33,7,689,148,358,0.413,30,86,0.349,118,272,0.434,0.455,62,75,0.827,15,47,62,94,21,5,29,33,388,NYK,2019
2621,Dennis Smith Jr.,21,21,18,600,121,293,0.413,24,83,0.289,97,210,0.462,0.454,42,74,0.568,14,44,58,114,27,9,54,47,308,NYK,2019
2622,DeAndre Jordan,30,19,19,493,78,123,0.634,0,0,,78,123,0.634,0.634,51,66,0.773,64,152,216,57,9,20,42,42,207,NYK,2019
2623,Kadeem Allen,26,19,1,416,65,141,0.461,17,36,0.472,48,105,0.457,0.521,42,54,0.778,8,43,51,76,16,4,26,46,189,NYK,2019
2624,John Jenkins,27,22,0,319,40,103,0.388,20,56,0.357,20,47,0.426,0.485,15,18,0.833,6,30,36,21,0,2,9,10,115,NYK,2019
2625,Henry Ellenson,22,17,0,234,35,85,0.412,15,34,0.441,20,51,0.392,0.500,17,23,0.739,5,52,57,15,7,2,9,25,102,NYK,2019
2626,Courtney Lee,33,12,2,160,21,47,0.447,5,16,0.313,16,31,0.516,0.500,9,14,0.643,6,21,27,16,8,2,5,13,56,NYK,2019
2627,Ron Baker,25,11,0,107,4,16,0.250,1,9,0.111,3,7,0.429,0.281,5,6,0.833,1,6,7,13,5,0,3,16,14,NYK,2019
2628,Billy Garrett,24,4,0,63,11,27,0.407,0,8,0.000,11,19,0.579,0.407,4,4,1.000,0,3,3,7,1,1,2,3,26,NYK,2019
2629,Wesley Matthews,32,2,1,54,4,19,0.211,2,10,0.200,2,9,0.222,0.263,4,5,0.800,1,2,3,5,1,1,2,2,14,NYK,2019
2630,Isaiah Hicks,24,3,0,32,4,8,0.500,0,0,,4,8,0.500,0.500,4,5,0.800,2,5,7,2,1,3,1,5,12,NYK,2019
2631,D'Angelo Russell,22,81,81,2448,659,1517,0.434,234,635,0.369,425,882,0.482,0.512,160,205,0.780,53,262,315,563,100,20,253,141,1712,BRK,2019
2632,Joe Harris,27,76,76,2293,374,748,0.500,183,386,0.474,191,362,0.528,0.622,110,133,0.827,52,239,291,181,38,17,121,182,1041,BRK,2019
2633,Jarrett Allen,20,80,80,2096,335,568,0.590,6,45,0.133,329,523,0.629,0.595,197,278,0.709,191,481,672,110,43,120,103,184,873,BRK,2019
2634,Spencer Dinwiddie,25,68,4,1914,366,828,0.442,124,370,0.335,242,458,0.528,0.517,287,356,0.806,26,140,166,311,40,17,152,187,1143,BRK,2019
2635,DeMarre Carroll,32,67,8,1703,227,575,0.395,106,310,0.342,121,265,0.457,0.487,184,242,0.760,68,281,349,85,31,10,73,114,744,BRK,2019
2636,Ed Davis,29,81,1,1446,186,302,0.616,0,2,0.000,186,300,0.620,0.616,100,162,0.617,216,478,694,61,35,33,64,226,472,BRK,2019
2637,Rodions Kurucs,20,63,46,1294,202,449,0.450,58,184,0.315,144,265,0.543,0.514,72,92,0.783,56,190,246,52,41,25,77,146,534,BRK,2019
2638,Rondae Hollis-Jefferson,24,59,21,1234,200,487,0.411,9,49,0.184,191,438,0.436,0.420,118,183,0.645,83,227,310,96,44,27,68,107,527,BRK,2019
2639,Jared Dudley,33,59,25,1220,101,239,0.423,53,151,0.351,48,88,0.545,0.533,32,46,0.696,34,121,155,83,36,16,43,131,287,BRK,2019
2640,Allen Crabbe,26,43,20,1133,137,373,0.367,98,259,0.378,39,114,0.342,0.499,41,56,0.732,16,132,148,46,23,13,46,102,413,BRK,2019
1951,James Harden,30,68,68,2483,672,1514,0.444,299,843,0.355,373,671,0.556,0.543,692,800,0.865,70,376,446,512,125,60,308,227,2335,HOU,2020
1952,P.J. Tucker,34,72,72,2467,177,426,0.415,107,299,0.358,70,127,0.551,0.541,39,48,0.813,112,364,476,115,77,36,72,229,500,HOU,2020
1953,Russell Westbrook,31,57,57,2049,604,1281,0.472,55,213,0.258,549,1068,0.514,0.493,290,380,0.763,100,351,451,401,93,20,255,200,1553,HOU,2020
1954,Danuel House Jr.,26,63,52,1913,230,539,0.427,129,355,0.363,101,184,0.549,0.546,73,90,0.811,57,210,267,85,67,34,54,132,662,HOU,2020
1955,Ben McLemore,26,71,23,1619,242,545,0.444,181,452,0.400,61,93,0.656,0.610,50,67,0.746,21,136,157,58,45,16,50,155,715,HOU,2020
1956,Austin Rivers,27,68,4,1594,211,501,0.421,96,270,0.356,115,231,0.498,0.517,78,111,0.703,27,148,175,113,49,10,50,129,596,HOU,2020
1957,Clint Capela,25,39,39,1279,244,388,0.629,0,0,,244,388,0.629,0.629,55,104,0.529,168,369,537,48,33,72,63,102,543,HOU,2020
1958,Eric Gordon,31,36,15,1016,171,463,0.369,96,303,0.317,75,160,0.469,0.473,82,107,0.766,9,62,71,54,23,13,43,70,520,HOU,2020
1959,Robert Covington,29,22,21,726,89,227,0.392,53,168,0.315,36,59,0.610,0.509,24,30,0.800,27,149,176,32,35,48,30,72,255,HOU,2020
1960,Thabo Sefolosha,35,41,0,436,37,91,0.407,15,54,0.278,22,37,0.595,0.489,3,8,0.375,21,72,93,25,24,12,15,43,92,HOU,2020
1961,Jeff Green,33,18,2,407,84,149,0.564,28,79,0.354,56,70,0.800,0.658,24,28,0.857,10,42,52,30,14,9,15,43,220,HOU,2020
1962,Chris Clemons,22,33,0,291,57,142,0.401,37,107,0.346,20,35,0.571,0.532,10,11,0.909,4,26,30,27,9,6,19,26,161,HOU,2020
1963,Isaiah Hartenstein,21,23,2,266,44,67,0.657,0,5,0.000,44,62,0.710,0.657,19,28,0.679,29,61,90,18,9,12,16,41,107,HOU,2020
1964,Tyson Chandler,37,26,5,219,14,18,0.778,0,0,,14,18,0.778,0.778,6,13,0.462,25,41,66,6,6,8,8,32,34,HOU,2020
1965,Gary Clark,25,18,0,212,23,59,0.390,18,51,0.353,5,8,0.625,0.542,6,7,0.857,11,29,40,12,2,7,2,21,70,HOU,2020
1966,DeMarre Carroll,33,9,0,155,16,37,0.432,5,20,0.250,11,17,0.647,0.500,17,22,0.773,5,19,24,14,6,3,7,12,54,HOU,2020
1967,Michael Frazier,25,13,0,145,7,29,0.241,4,23,0.174,3,6,0.500,0.310,9,14,0.643,1,9,10,2,2,0,5,22,27,HOU,2020
1968,Bruno Caboclo,24,8,0,52,10,20,0.500,2,8,0.250,8,12,0.667,0.550,6,6,1.000,6,10,16,2,5,5,6,8,28,HOU,2020
1969,Luc Mbah a Moute,33,3,0,25,2,5,0.400,0,2,0.000,2,3,0.667,0.400,1,2,0.500,1,1,2,0,2,0,1,0,5,HOU,2020
1970,Ryan Anderson,31,2,0,14,2,7,0.286,1,5,0.200,1,2,0.500,0.357,0,0,,0,7,7,2,1,0,1,1,5,HOU,2020
1971,William Howard,26,2,0,13,0,4,0.000,0,4,0.000,0,0,,0.000,0,0,,0,2,2,1,0,0,1,1,0,HOU,2020
1972,Tobias Harris,27,72,72,2469,553,1173,0.471,131,357,0.367,422,816,0.517,0.527,174,216,0.806,69,426,495,227,53,40,104,165,1411,PHI,2020
1973,Al Horford,33,67,61,2025,319,709,0.450,99,283,0.350,220,426,0.516,0.520,61,80,0.763,103,353,456,270,52,61,80,142,798,PHI,2020
1974,Ben Simmons,23,57,57,2017,375,647,0.580,2,7,0.286,373,640,0.583,0.581,185,298,0.621,113,331,444,455,119,33,200,186,937,PHI,2020
1975,Josh Richardson,26,55,53,1693,278,646,0.430,85,249,0.341,193,397,0.486,0.496,114,141,0.809,41,133,174,162,52,36,104,136,755,PHI,2020
1976,Furkan Korkmaz,22,72,12,1559,242,563,0.430,143,356,0.402,99,207,0.478,0.557,77,102,0.755,18,150,168,79,41,16,59,98,704,PHI,2020
1977,Joel Embiid,25,51,51,1506,382,801,0.477,57,172,0.331,325,629,0.517,0.512,351,435,0.807,141,452,593,152,45,65,159,174,1172,PHI,2020
1978,Matisse Thybulle,22,65,14,1287,112,265,0.423,56,157,0.357,56,108,0.519,0.528,25,41,0.610,44,63,107,79,94,47,51,141,305,PHI,2020
1979,Mike Scott,31,68,11,1207,149,350,0.426,80,217,0.369,69,133,0.519,0.540,30,37,0.811,65,183,248,56,21,5,26,96,408,PHI,2020
1980,Shake Milton,23,40,24,805,134,277,0.484,58,135,0.430,76,142,0.535,0.588,51,65,0.785,15,73,88,104,20,7,47,92,377,PHI,2020
1981,James Ennis III,29,49,0,776,100,226,0.442,37,106,0.349,63,120,0.525,0.524,48,61,0.787,48,102,150,41,23,14,31,85,285,PHI,2020
1982,Raul Neto,27,54,3,668,101,222,0.455,34,88,0.386,67,134,0.500,0.532,39,47,0.830,11,50,61,95,24,6,47,50,275,PHI,2020
1983,Alec Burks,28,18,1,364,77,167,0.461,32,77,0.416,45,90,0.500,0.557,34,41,0.829,11,45,56,38,12,0,15,21,220,PHI,2020
1984,Trey Burke,27,25,0,329,59,127,0.465,16,38,0.421,43,89,0.483,0.528,13,18,0.722,15,20,35,53,7,1,12,21,147,PHI,2020
1985,Kyle O'Quinn,29,29,2,313,42,85,0.494,7,27,0.259,35,58,0.603,0.535,11,20,0.550,34,82,116,51,7,24,20,37,102,PHI,2020
1986,Glenn Robinson III,26,14,4,270,44,85,0.518,9,27,0.333,35,58,0.603,0.571,11,12,0.917,15,29,44,11,9,2,5,18,108,PHI,2020
1987,Norvel Pelle,26,24,0,232,25,48,0.521,0,1,0.000,25,47,0.532,0.521,7,14,0.500,20,52,72,8,3,31,18,55,57,PHI,2020
1988,Zhaire Smith,20,7,0,32,3,11,0.273,0,3,0.000,3,8,0.375,0.273,2,4,0.500,0,2,2,2,3,0,2,4,8,PHI,2020
1989,Marial Shayok,24,4,0,28,3,12,0.250,2,6,0.333,1,6,0.167,0.333,3,4,0.750,1,6,7,1,0,1,3,4,11,PHI,2020
1990,Jonah Bolden,24,4,0,14,2,3,0.667,0,1,0.000,2,2,1.000,0.667,0,2,0.000,0,1,1,0,1,0,2,4,4,PHI,2020
1991,Jayson Tatum,21,66,66,2265,552,1226,0.450,189,469,0.403,363,757,0.480,0.527,254,313,0.812,64,396,460,200,93,57,155,136,1547,BOS,2020
1992,Jaylen Brown,23,57,57,1934,427,887,0.481,129,338,0.382,298,549,0.543,0.554,176,243,0.724,62,302,364,118,65,20,125,167,1159,BOS,2020
1993,Marcus Smart,25,60,40,1919,256,682,0.375,137,395,0.347,119,287,0.415,0.476,127,152,0.836,42,183,225,291,101,29,103,162,776,BOS,2020
1994,Kemba Walker,29,56,56,1742,378,889,0.425,180,473,0.381,198,416,0.476,0.526,209,242,0.864,36,181,217,268,48,28,117,91,1145,BOS,2020
1995,Gordon Hayward,29,52,52,1740,350,700,0.500,85,222,0.383,265,478,0.554,0.561,124,145,0.855,55,293,348,212,38,22,96,96,909,BOS,2020
1996,Daniel Theis,27,65,64,1566,241,426,0.566,32,96,0.333,209,330,0.633,0.603,87,114,0.763,140,286,426,111,37,84,54,219,601,BOS,2020
1997,Brad Wanamaker,30,71,1,1369,162,362,0.448,37,102,0.363,125,260,0.481,0.499,126,136,0.926,22,122,144,179,61,14,76,133,487,BOS,2020
1998,Grant Williams,21,69,5,1043,87,211,0.412,24,96,0.250,63,115,0.548,0.469,39,54,0.722,59,119,178,68,30,36,50,163,237,BOS,2020
1999,Semi Ojeleye,25,69,6,1011,80,196,0.408,48,127,0.378,32,69,0.464,0.531,28,32,0.875,26,119,145,37,21,5,19,80,236,BOS,2020
2000,Enes Freedom,27,58,7,983,199,348,0.572,1,7,0.143,198,341,0.581,0.573,70,99,0.707,163,268,431,56,22,41,56,100,469,BOS,2020
2001,Javonte Green,26,48,2,468,63,126,0.500,9,33,0.273,54,93,0.581,0.536,28,42,0.667,24,69,93,26,24,8,23,43,163,BOS,2020
2002,Robert Williams,22,29,1,388,64,88,0.727,0,0,,64,88,0.727,0.727,22,34,0.647,40,88,128,27,22,35,21,51,150,BOS,2020
2003,Romeo Langford,20,32,2,370,28,80,0.350,5,27,0.185,23,53,0.434,0.381,18,25,0.720,15,26,41,13,8,8,11,33,79,BOS,2020
2004,Carsen Edwards,21,37,0,351,42,128,0.328,24,76,0.316,18,52,0.346,0.422,13,19,0.684,6,41,47,24,12,4,15,34,121,BOS,2020
2005,Vincent Poirier,26,22,0,130,17,36,0.472,1,2,0.500,16,34,0.471,0.486,6,7,0.857,13,30,43,8,2,9,8,25,41,BOS,2020
2006,Tremont Waters,22,11,1,119,14,49,0.286,4,24,0.167,10,25,0.400,0.327,8,8,1.000,0,12,12,16,10,2,15,13,40,BOS,2020
2007,Tacko Fall,24,7,0,33,11,14,0.786,0,0,,11,14,0.786,0.786,1,3,0.333,1,14,15,1,1,4,3,7,23,BOS,2020
2008,Julius Randle,25,64,64,2080,463,1006,0.460,64,231,0.277,399,775,0.515,0.492,258,352,0.733,151,471,622,198,51,22,193,178,1248,NYK,2020
2009,RJ Barrett,19,56,55,1704,292,727,0.402,63,197,0.320,229,530,0.432,0.445,156,254,0.614,50,229,279,143,55,17,124,122,803,NYK,2020
2010,Mitchell Robinson,21,61,7,1412,253,341,0.742,0,0,,253,341,0.742,0.742,84,148,0.568,186,242,428,36,52,119,37,194,590,NYK,2020
2011,Bobby Portis,24,66,5,1393,265,589,0.450,67,187,0.358,198,402,0.493,0.507,71,93,0.763,80,258,338,98,32,18,73,110,668,NYK,2020
2012,Marcus Morris,30,43,43,1387,281,636,0.442,116,264,0.439,165,372,0.444,0.533,163,198,0.823,48,185,233,59,34,17,73,128,841,NYK,2020
2013,Elfrid Payton,25,45,36,1246,193,440,0.439,14,69,0.203,179,371,0.482,0.455,49,86,0.570,52,160,212,323,70,17,96,89,449,NYK,2020
2014,Frank Ntilikina,21,57,26,1187,131,333,0.393,44,137,0.321,87,196,0.444,0.459,51,59,0.864,23,98,121,172,54,16,71,142,357,NYK,2020
2015,Kevin Knox,20,65,4,1166,144,401,0.359,65,199,0.327,79,202,0.391,0.440,66,101,0.653,28,156,184,61,23,28,45,106,419,NYK,2020
2016,Taj Gibson,34,62,56,1025,167,286,0.584,4,14,0.286,163,272,0.599,0.591,41,56,0.732,111,156,267,52,27,30,47,122,379,NYK,2020
2017,Damyean Dotson,25,48,0,836,120,290,0.414,59,163,0.362,61,127,0.480,0.516,22,33,0.667,10,81,91,57,23,4,21,44,321,NYK,2020
2018,Reggie Bullock,28,29,19,684,90,224,0.402,37,111,0.333,53,113,0.469,0.484,17,21,0.810,13,55,68,42,25,3,19,56,234,NYK,2020
2019,Wayne Ellington,32,36,1,558,61,174,0.351,50,143,0.350,11,31,0.355,0.494,11,13,0.846,4,61,65,44,13,4,18,41,183,NYK,2020
2020,Dennis Smith Jr.,22,34,3,537,72,211,0.341,16,54,0.296,56,157,0.357,0.379,27,53,0.509,21,57,78,98,28,8,58,65,187,NYK,2020
2021,Allonzo Trier,24,24,1,291,51,106,0.481,19,53,0.358,32,53,0.604,0.571,34,43,0.791,6,23,29,28,3,4,22,29,155,NYK,2020
2022,Maurice Harkless,26,12,10,286,30,66,0.455,7,25,0.280,23,41,0.561,0.508,15,24,0.625,8,32,40,20,9,3,7,28,82,NYK,2020
2023,Kadeem Allen,27,10,0,117,19,44,0.432,5,16,0.313,14,28,0.500,0.489,7,11,0.636,2,7,9,21,5,2,8,7,50,NYK,2020
2024,Ignas Brazdeikis,21,9,0,53,6,22,0.273,1,9,0.111,5,13,0.385,0.295,4,5,0.800,2,3,5,4,0,1,2,3,17,NYK,2020
2025,Joe Harris,28,69,69,2123,381,784,0.486,172,406,0.424,209,378,0.553,0.596,64,89,0.719,64,234,298,144,41,17,104,159,998,BRK,2020
2026,Spencer Dinwiddie,26,64,49,1994,424,1021,0.415,123,400,0.308,301,621,0.485,0.476,347,446,0.778,32,189,221,432,40,21,174,180,1318,BRK,2020
2027,Taurean Prince,25,64,61,1857,278,739,0.376,146,431,0.339,132,308,0.429,0.475,71,89,0.798,50,331,381,116,57,25,127,159,773,BRK,2020
2028,Jarrett Allen,21,70,64,1852,302,465,0.649,0,6,0.000,302,459,0.658,0.649,171,270,0.633,216,455,671,110,40,92,77,162,775,BRK,2020
2029,Garrett Temple,33,62,35,1730,222,587,0.378,127,386,0.329,95,201,0.473,0.486,70,87,0.805,29,189,218,156,49,29,62,108,641,BRK,2020
2030,Caris LeVert,25,45,31,1330,311,732,0.425,80,220,0.364,231,512,0.451,0.480,140,197,0.711,49,140,189,199,53,10,118,81,842,BRK,2020
2031,DeAndre Jordan,31,56,6,1234,191,287,0.666,0,0,,191,287,0.666,0.666,83,122,0.680,141,420,561,105,18,52,74,114,465,BRK,2020
2032,Timothé Luwawu-Cabarrot,24,47,2,853,117,269,0.435,62,160,0.388,55,109,0.505,0.550,69,81,0.852,29,98,127,29,18,7,37,106,365,BRK,2020
2033,Wilson Chandler,32,35,3,734,74,183,0.404,37,121,0.306,37,62,0.597,0.505,20,23,0.870,11,134,145,39,16,12,34,79,205,BRK,2020
2034,Rodions Kurucs,21,47,9,684,79,177,0.446,33,90,0.367,46,87,0.529,0.540,24,38,0.632,25,112,137,51,25,5,46,90,215,BRK,2020
2035,Kyrie Irving,27,20,20,658,199,416,0.478,56,142,0.394,143,274,0.522,0.546,94,102,0.922,22,81,103,128,27,10,52,53,548,BRK,2020
2036,Džanan Musa,20,40,0,487,64,172,0.372,19,78,0.244,45,94,0.479,0.427,45,60,0.750,21,65,86,43,15,1,36,30,192,BRK,2020
2037,Theo Pinson,24,33,0,365,45,155,0.290,15,80,0.188,30,75,0.400,0.339,15,16,0.938,10,44,54,56,17,4,33,35,120,BRK,2020
2038,Chris Chiozza,24,18,2,278,45,106,0.425,20,56,0.357,25,50,0.500,0.519,5,5,1.000,9,29,38,55,11,2,23,25,115,BRK,2020
2039,David Nwaba,27,20,0,268,37,71,0.521,12,28,0.429,25,43,0.581,0.606,18,27,0.667,8,37,45,8,11,12,8,32,104,BRK,2020
2040,Iman Shumpert,29,13,0,241,21,64,0.328,8,33,0.242,13,31,0.419,0.391,4,7,0.571,9,25,34,12,12,2,10,21,54,BRK,2020
2041,Tyler Johnson,27,8,4,194,32,79,0.405,14,36,0.389,18,43,0.419,0.494,18,18,1.000,8,16,24,24,4,1,5,15,96,BRK,2020
2042,Nic Claxton,20,15,0,187,27,48,0.563,1,7,0.143,26,41,0.634,0.573,11,21,0.524,19,25,44,16,1,8,9,14,66,BRK,2020
2043,Justin Anderson,26,10,1,107,10,38,0.263,6,29,0.207,4,9,0.444,0.342,2,4,0.500,1,20,21,8,0,6,4,13,28,BRK,2020
2044,Jeremiah Martin,23,9,0,99,24,53,0.453,5,18,0.278,19,35,0.543,0.500,11,14,0.786,1,9,10,18,7,2,4,7,64,BRK,2020
2045,Lance Thomas,31,7,4,98,8,23,0.348,4,13,0.308,4,10,0.400,0.435,4,4,1.000,2,11,13,6,0,0,6,11,24,BRK,2020
2046,Donta Hall,22,5,0,85,14,18,0.778,0,0,,14,18,0.778,0.778,5,12,0.417,8,15,23,2,2,5,3,14,33,BRK,2020
2047,Henry Ellenson,23,5,0,15,1,7,0.143,0,4,0.000,1,3,0.333,0.143,0,0,,2,4,6,1,0,0,0,1,2,BRK,2020
2048,Jamal Crawford,39,1,0,6,2,4,0.500,1,2,0.500,1,2,0.500,0.625,0,0,,0,0,0,3,0,0,0,1,5,BRK,2020
2049,Pascal Siakam,25,60,60,2110,500,1104,0.453,131,365,0.359,369,739,0.499,0.512,240,303,0.792,64,375,439,207,61,53,148,170,1371,TOR,2020
2050,Kyle Lowry,33,58,58,2098,334,803,0.416,164,466,0.352,170,337,0.504,0.518,294,343,0.857,32,260,292,433,82,26,178,190,1126,TOR,2020
1325,Jae'Sean Tate,25,70,58,2043,316,625,0.506,60,195,0.308,256,430,0.595,0.554,102,147,0.694,132,242,374,178,85,36,98,222,794,HOU,2021
1326,Christian Wood,25,41,41,1326,329,640,0.514,77,206,0.374,252,434,0.581,0.574,125,198,0.631,76,319,395,71,34,48,80,88,860,HOU,2021
1327,John Wall,30,40,40,1288,293,726,0.404,79,249,0.317,214,477,0.449,0.458,158,211,0.749,17,112,129,275,42,31,141,46,823,HOU,2021
1328,Sterling Brown,25,51,14,1229,150,335,0.448,91,215,0.423,59,120,0.492,0.584,25,31,0.806,38,186,224,72,38,12,41,97,416,HOU,2021
1329,Kenyon Martin Jr.,20,45,8,1068,162,318,0.509,35,96,0.365,127,222,0.572,0.564,60,84,0.714,73,169,242,48,30,41,38,89,419,HOU,2021
1330,P.J. Tucker,35,32,32,959,48,131,0.366,27,86,0.314,21,45,0.467,0.469,18,23,0.783,33,115,148,45,29,18,33,91,141,HOU,2021
1331,Danuel House Jr.,27,36,23,932,110,272,0.404,54,156,0.346,56,116,0.483,0.504,41,63,0.651,18,114,132,69,20,16,36,67,315,HOU,2021
1332,Kelly Olynyk,29,27,24,840,175,321,0.545,49,125,0.392,126,196,0.643,0.621,114,135,0.844,43,185,228,112,39,16,71,84,513,HOU,2021
1333,Kevin Porter Jr.,20,26,23,835,156,367,0.425,50,161,0.311,106,206,0.515,0.493,69,94,0.734,20,79,99,164,19,8,91,61,431,HOU,2021
1334,Eric Gordon,32,27,13,789,159,367,0.433,69,210,0.329,90,157,0.573,0.527,94,114,0.825,8,50,58,71,14,13,51,44,481,HOU,2021
1335,David Nwaba,28,30,9,679,106,218,0.486,17,63,0.270,89,155,0.574,0.525,47,68,0.691,40,78,118,31,30,21,17,60,276,HOU,2021
1336,Victor Oladipo,28,20,20,669,155,381,0.407,49,153,0.320,106,228,0.465,0.471,65,83,0.783,8,87,95,99,24,10,51,45,424,HOU,2021
1337,Ben McLemore,27,32,4,537,80,224,0.357,55,166,0.331,25,58,0.431,0.480,23,32,0.719,11,55,66,28,20,3,28,51,238,HOU,2021
1338,Armoni Brooks,22,20,5,520,78,192,0.406,60,157,0.382,18,35,0.514,0.563,7,12,0.583,10,58,68,30,12,5,22,34,223,HOU,2021
1339,DeMarcus Cousins,30,25,11,506,79,210,0.376,39,116,0.336,40,94,0.426,0.469,44,59,0.746,30,161,191,60,21,18,39,74,241,HOU,2021
1340,D.J. Augustin,33,20,6,416,64,151,0.424,34,88,0.386,30,63,0.476,0.536,49,54,0.907,9,35,44,78,8,0,31,23,211,HOU,2021
1341,Anthony Lamb,23,24,3,415,46,118,0.390,23,71,0.324,23,47,0.489,0.487,18,21,0.857,27,43,70,23,6,5,19,34,133,HOU,2021
1342,Avery Bradley,30,17,5,391,33,105,0.314,17,63,0.270,16,42,0.381,0.395,5,6,0.833,6,33,39,32,14,2,19,29,88,HOU,2021
1343,D.J. Wilson,24,23,1,328,52,125,0.416,20,59,0.339,32,66,0.485,0.496,16,23,0.696,17,70,87,20,10,12,18,31,140,HOU,2021
1344,Mason Jones,22,26,1,307,47,114,0.412,23,64,0.359,24,50,0.480,0.513,35,57,0.614,4,47,51,39,6,1,28,22,152,HOU,2021
1345,James Harden,31,8,8,290,60,135,0.444,25,72,0.347,35,63,0.556,0.537,53,60,0.883,5,36,41,83,7,6,34,14,198,HOU,2021
1346,DaQuan Jeffries,23,13,3,261,26,63,0.413,11,39,0.282,15,24,0.625,0.500,1,1,1.000,10,32,42,16,8,6,6,25,64,HOU,2021
1347,Justin Patton,23,13,6,247,29,70,0.414,9,34,0.265,20,36,0.556,0.479,3,4,0.750,14,35,49,14,12,14,4,34,70,HOU,2021
1348,Khyri Thomas,24,5,2,153,32,66,0.485,9,27,0.333,23,39,0.590,0.553,9,9,1.000,7,11,18,25,9,6,6,8,82,HOU,2021
1349,Cameron Oliver,24,4,0,87,19,33,0.576,4,13,0.308,15,20,0.750,0.636,1,4,0.250,5,16,21,5,2,4,3,11,43,HOU,2021
1350,Rodions Kurucs,22,11,0,75,5,21,0.238,2,15,0.133,3,6,0.500,0.286,1,2,0.500,2,9,11,4,6,4,9,7,13,HOU,2021
1351,Bruno Caboclo,25,6,0,36,8,17,0.471,0,5,0.000,8,12,0.667,0.471,1,2,0.500,3,11,14,1,0,2,4,6,17,HOU,2021
1352,Cameron Reynolds,25,2,0,34,5,16,0.313,3,12,0.250,2,4,0.500,0.406,0,0,,2,3,5,2,0,0,0,2,13,HOU,2021
1353,Brodric Thomas,24,4,0,24,2,7,0.286,1,6,0.167,1,1,1.000,0.357,5,7,0.714,1,3,4,4,1,1,4,5,10,HOU,2021
1354,Ray Spalding,23,2,0,19,2,4,0.500,0,1,0.000,2,3,0.667,0.500,0,2,0.000,2,2,4,0,0,2,3,3,4,HOU,2021
1355,Tobias Harris,28,62,62,2014,473,924,0.512,82,208,0.394,391,716,0.546,0.556,182,204,0.892,62,357,419,220,55,51,107,119,1210,PHI,2021
1356,Danny Green,33,69,69,1934,224,544,0.412,175,432,0.405,49,112,0.438,0.573,31,40,0.775,55,205,260,118,92,56,67,125,654,PHI,2021
1357,Ben Simmons,24,58,58,1877,325,583,0.557,3,10,0.300,322,573,0.562,0.560,176,287,0.613,93,324,417,401,93,35,173,171,829,PHI,2021
1358,Seth Curry,30,57,57,1638,258,552,0.467,126,280,0.450,132,272,0.485,0.582,69,77,0.896,10,126,136,155,44,8,65,96,711,PHI,2021
1359,Joel Embiid,26,51,51,1585,461,899,0.513,58,154,0.377,403,745,0.541,0.545,471,548,0.859,113,426,539,145,50,69,159,123,1451,PHI,2021
1360,Shake Milton,24,63,4,1461,300,667,0.450,71,203,0.350,229,464,0.494,0.503,146,176,0.830,33,115,148,193,39,18,103,130,817,PHI,2021
1361,Matisse Thybulle,23,65,8,1298,102,243,0.420,43,143,0.301,59,100,0.590,0.508,8,18,0.444,30,94,124,63,105,71,32,127,255,PHI,2021
1362,Dwight Howard,35,69,6,1196,178,303,0.587,5,20,0.250,173,283,0.611,0.596,121,210,0.576,190,390,580,61,30,62,112,200,482,PHI,2021
1363,Furkan Korkmaz,23,55,11,1062,170,424,0.401,101,269,0.375,69,155,0.445,0.520,60,82,0.732,17,96,113,82,49,9,46,64,501,PHI,2021
1364,Tyrese Maxey,20,61,8,935,198,429,0.462,31,103,0.301,167,326,0.512,0.498,61,70,0.871,11,93,104,120,26,13,41,79,488,PHI,2021
1365,Mike Scott,32,51,12,852,76,211,0.360,53,155,0.342,23,56,0.411,0.486,8,12,0.667,11,109,120,40,24,14,19,72,213,PHI,2021
1366,Isaiah Joe,21,41,1,383,48,133,0.361,39,106,0.368,9,27,0.333,0.508,18,24,0.750,6,30,36,20,12,4,11,34,153,PHI,2021
1367,George Hill,34,16,3,303,34,77,0.442,9,23,0.391,25,54,0.463,0.500,19,25,0.760,8,24,32,30,11,3,19,19,96,PHI,2021
1368,Tony Bradley,23,20,8,287,51,75,0.680,0,1,0.000,51,74,0.689,0.680,7,11,0.636,39,65,104,17,6,13,6,28,109,PHI,2021
1369,Paul Reed,21,26,0,177,42,78,0.538,0,6,0.000,42,72,0.583,0.538,4,8,0.500,30,31,61,12,10,13,12,29,88,PHI,2021
1370,Dakota Mathias,25,8,2,123,19,48,0.396,8,26,0.308,11,22,0.500,0.479,2,6,0.333,1,6,7,13,1,3,1,7,48,PHI,2021
1371,Anthony Tolliver,35,11,0,99,4,17,0.235,4,14,0.286,0,3,0.000,0.353,5,6,0.833,3,7,10,2,3,2,3,7,17,PHI,2021
1372,Rayjon Tucker,23,14,0,68,9,18,0.500,2,7,0.286,7,11,0.636,0.556,14,19,0.737,1,10,11,6,2,0,4,8,34,PHI,2021
1373,Terrance Ferguson,22,13,0,49,1,7,0.143,0,5,0.000,1,2,0.500,0.143,0,0,,0,1,1,2,1,0,4,7,2,PHI,2021
1374,Vincent Poirier,27,10,0,39,3,12,0.250,0,1,0.000,3,11,0.273,0.250,2,6,0.333,6,8,14,2,0,3,4,8,8,PHI,2021
1375,Mason Jones,22,6,0,27,5,9,0.556,1,2,0.500,4,7,0.571,0.611,5,7,0.714,3,1,4,3,1,0,1,2,16,PHI,2021
1376,Gary Clark,26,2,0,13,0,1,0.000,0,0,,0,1,0.000,0.000,0,0,,0,2,2,1,1,0,0,1,0,PHI,2021
1377,Ignas Brazdeikis,22,1,0,8,0,3,0.000,0,1,0.000,0,2,0.000,0.000,0,0,,0,2,2,0,0,0,0,0,0,PHI,2021
1378,Jayson Tatum,22,64,64,2290,605,1318,0.459,187,485,0.386,418,833,0.502,0.530,295,340,0.868,50,422,472,276,75,31,171,122,1692,BOS,2021
1379,Jaylen Brown,24,58,58,1999,538,1111,0.484,163,411,0.397,375,700,0.536,0.558,191,250,0.764,71,276,347,195,72,32,158,168,1430,BOS,2021
1380,Marcus Smart,26,48,45,1581,203,510,0.398,93,282,0.330,110,228,0.482,0.489,128,162,0.790,36,131,167,273,72,23,96,126,627,BOS,2021
1381,Kemba Walker,30,43,43,1369,284,676,0.420,127,353,0.360,157,323,0.486,0.514,134,149,0.899,16,154,170,212,48,12,88,61,829,BOS,2021
1382,Tristan Thompson,29,54,43,1287,169,326,0.518,0,3,0.000,169,323,0.523,0.518,71,120,0.592,169,270,439,67,24,33,62,119,409,BOS,2021
1383,Payton Pritchard,23,66,4,1268,184,418,0.440,102,248,0.411,82,170,0.482,0.562,40,45,0.889,33,125,158,120,37,9,53,104,510,BOS,2021
1384,Grant Williams,22,63,9,1138,108,247,0.437,48,129,0.372,60,118,0.508,0.534,30,51,0.588,48,130,178,64,32,24,56,161,294,BOS,2021
1385,Daniel Theis,28,42,37,1027,159,288,0.552,33,95,0.347,126,193,0.653,0.609,46,67,0.687,54,166,220,67,25,43,41,120,397,BOS,2021
1386,Robert Williams,23,52,13,985,186,258,0.721,0,2,0.000,186,256,0.727,0.721,45,73,0.616,133,225,358,94,43,91,52,105,417,BOS,2021
1387,Semi Ojeleye,26,56,15,950,89,221,0.403,58,158,0.367,31,63,0.492,0.534,24,32,0.750,31,116,147,37,17,0,21,56,260,BOS,2021
1388,Aaron Nesmith,21,46,1,669,78,178,0.438,40,108,0.370,38,70,0.543,0.551,22,28,0.786,28,99,127,23,15,9,23,87,218,BOS,2021
1389,Jeff Teague,32,34,5,616,78,188,0.415,26,56,0.464,52,132,0.394,0.484,51,61,0.836,10,47,57,73,26,7,39,43,233,BOS,2021
1390,Evan Fournier,28,16,10,472,77,172,0.448,44,95,0.463,33,77,0.429,0.576,10,14,0.714,5,48,53,49,20,10,19,41,208,BOS,2021
1391,Javonte Green,27,25,2,345,39,71,0.549,7,22,0.318,32,49,0.653,0.599,20,30,0.667,20,32,52,11,18,2,13,32,105,BOS,2021
1392,Romeo Langford,21,18,4,283,21,59,0.356,5,18,0.278,16,41,0.390,0.398,9,12,0.750,12,23,35,13,6,5,10,24,56,BOS,2021
1393,Carsen Edwards,22,31,1,276,47,111,0.423,18,63,0.286,29,48,0.604,0.505,11,13,0.846,3,23,26,14,7,1,7,25,123,BOS,2021
1394,Luke Kornet,25,18,2,254,35,74,0.473,9,36,0.250,26,38,0.684,0.534,1,2,0.500,13,39,52,20,2,25,6,19,80,BOS,2021
1395,Tremont Waters,23,26,3,238,34,84,0.405,15,38,0.395,19,46,0.413,0.494,16,17,0.941,5,16,21,62,15,1,27,17,99,BOS,2021
1396,Jabari Parker,25,10,0,138,26,48,0.542,2,10,0.200,24,38,0.632,0.563,10,13,0.769,9,27,36,10,1,4,7,9,64,BOS,2021
1397,Tacko Fall,25,19,0,136,21,29,0.724,0,0,,21,29,0.724,0.724,5,15,0.333,16,36,52,3,1,20,6,22,47,BOS,2021
1398,Moritz Wagner,23,9,1,61,4,14,0.286,2,6,0.333,2,8,0.250,0.357,1,2,0.500,3,16,19,6,0,1,9,10,11,BOS,2021
1399,Julius Randle,26,71,71,2667,602,1321,0.456,160,389,0.411,442,932,0.474,0.516,348,429,0.811,84,639,723,427,64,18,241,225,1712,NYK,2021
1400,RJ Barrett,20,72,72,2511,467,1060,0.441,124,309,0.401,343,751,0.457,0.499,206,276,0.746,68,346,414,217,53,20,139,188,1264,NYK,2021
1401,Reggie Bullock,29,65,64,1949,248,561,0.442,163,398,0.410,85,163,0.521,0.587,50,55,0.909,16,207,223,99,52,11,45,146,709,NYK,2021
1402,Nerlens Noel,26,64,41,1547,137,223,0.614,0,3,0.000,137,220,0.623,0.614,50,70,0.714,142,266,408,46,70,141,65,176,324,NYK,2021
1403,Elfrid Payton,26,63,63,1484,269,622,0.432,28,98,0.286,241,524,0.460,0.455,73,107,0.682,64,152,216,203,47,9,103,116,639,NYK,2021
1404,Alec Burks,29,49,5,1255,210,500,0.420,102,246,0.415,108,254,0.425,0.522,101,118,0.856,21,206,227,107,31,14,49,102,623,NYK,2021
1405,Immanuel Quickley,21,64,3,1243,229,580,0.395,118,303,0.389,111,277,0.401,0.497,155,174,0.891,25,112,137,127,30,12,58,114,731,NYK,2021
1406,Derrick Rose,32,35,3,937,208,427,0.487,37,90,0.411,171,337,0.507,0.530,68,77,0.883,14,87,101,146,31,15,49,39,521,NYK,2021
1407,Taj Gibson,35,45,3,936,99,158,0.627,3,15,0.200,96,143,0.671,0.636,40,55,0.727,99,151,250,36,31,49,22,99,241,NYK,2021
1408,Mitchell Robinson,22,31,29,853,115,176,0.653,0,0,,115,176,0.653,0.653,26,53,0.491,113,139,252,17,35,45,26,86,256,NYK,2021
1409,Obi Toppin,22,62,0,683,104,209,0.498,26,85,0.306,78,124,0.629,0.560,19,26,0.731,26,112,138,29,17,15,23,55,253,NYK,2021
1410,Kevin Knox,21,42,0,464,56,143,0.392,35,89,0.393,21,54,0.389,0.514,16,20,0.800,10,51,61,19,12,6,17,37,163,NYK,2021
1411,Austin Rivers,28,21,2,442,58,135,0.430,28,77,0.364,30,58,0.517,0.533,10,14,0.714,5,42,47,42,12,0,22,32,154,NYK,2021
1412,Frank Ntilikina,22,33,4,322,29,79,0.367,23,48,0.479,6,31,0.194,0.513,8,18,0.444,6,25,31,19,18,4,11,45,89,NYK,2021
1413,Norvel Pelle,27,9,0,52,5,7,0.714,0,0,,5,7,0.714,0.714,1,2,0.500,2,9,11,1,1,6,0,4,11,NYK,2021
1414,Theo Pinson,25,17,0,34,1,9,0.111,0,8,0.000,1,1,1.000,0.111,0,0,,0,5,5,1,0,0,1,4,2,NYK,2021
1415,Dennis Smith Jr.,23,3,0,28,2,10,0.200,0,4,0.000,2,6,0.333,0.200,5,6,0.833,0,2,2,3,3,0,1,4,9,NYK,2021
1416,Jared Harper,23,8,0,16,0,4,0.000,0,1,0.000,0,3,0.000,0.000,3,4,0.750,0,2,2,1,0,0,3,1,3,NYK,2021
1417,Ignas Brazdeikis,22,4,0,7,0,1,0.000,0,0,,0,1,0.000,0.000,2,2,1.000,1,1,2,1,0,0,1,0,2,NYK,2021
1418,Joe Harris,29,69,65,2141,357,707,0.505,211,444,0.475,146,263,0.555,0.654,49,63,0.778,43,205,248,130,46,14,62,141,974,BRK,2021
1419,Kyrie Irving,28,54,54,1886,549,1086,0.506,152,378,0.402,397,708,0.561,0.576,201,218,0.922,52,205,257,324,76,37,130,140,1451,BRK,2021
1420,Jeff Green,34,68,38,1835,261,530,0.492,103,250,0.412,158,280,0.564,0.590,125,161,0.776,34,229,263,108,36,27,54,122,750,BRK,2021
1421,Bruce Brown,24,65,37,1451,235,423,0.556,17,59,0.288,218,364,0.599,0.576,86,117,0.735,111,238,349,104,58,28,54,145,573,BRK,2021
1422,Landry Shamet,23,61,12,1403,186,456,0.408,129,333,0.387,57,123,0.463,0.549,66,78,0.846,11,101,112,99,31,10,48,93,567,BRK,2021
1423,James Harden,31,36,35,1319,282,599,0.471,96,262,0.366,186,337,0.552,0.551,225,263,0.856,30,277,307,392,46,27,143,85,885,BRK,2021
1424,DeAndre Jordan,32,57,43,1246,190,249,0.763,0,1,0.000,190,248,0.766,0.763,46,92,0.500,117,310,427,93,17,65,85,116,426,BRK,2021
610,Jalen Green,19,67,67,2138,406,954,0.426,157,458,0.343,249,496,0.502,0.508,188,236,0.797,33,193,226,176,44,18,135,103,1157,HOU,2022
611,Christian Wood,26,68,67,2094,440,878,0.501,131,336,0.390,309,542,0.570,0.576,207,332,0.623,110,576,686,155,54,65,126,171,1218,HOU,2022
612,Jae'Sean Tate,26,78,77,2056,363,729,0.498,63,202,0.312,300,527,0.569,0.541,130,184,0.707,135,285,420,222,72,41,139,286,919,HOU,2022
613,Kevin Porter Jr.,21,61,61,1907,335,808,0.415,155,413,0.375,180,395,0.456,0.511,124,193,0.642,43,224,267,376,69,22,192,156,949,HOU,2022
614,Garrison Mathews,25,65,33,1712,184,461,0.399,139,386,0.360,45,75,0.600,0.550,143,180,0.794,32,158,190,64,57,24,41,168,650,HOU,2022
615,Eric Gordon,33,57,46,1669,268,564,0.475,124,301,0.412,144,263,0.548,0.585,105,135,0.778,15,98,113,154,28,18,107,63,765,HOU,2022
616,Kenyon Martin Jr.,21,79,2,1656,279,523,0.533,60,168,0.357,219,355,0.617,0.591,78,123,0.634,80,217,297,101,34,40,60,113,696,HOU,2022
617,Alperen Şengün,19,72,13,1489,249,525,0.474,29,117,0.248,220,408,0.539,0.502,165,232,0.711,138,255,393,185,59,68,145,214,692,HOU,2022
618,Josh Christopher,20,74,2,1334,224,500,0.448,56,189,0.296,168,311,0.540,0.504,83,113,0.735,52,134,186,150,65,13,114,97,587,HOU,2022
619,Armoni Brooks,23,41,8,690,87,251,0.347,64,213,0.300,23,38,0.605,0.474,16,19,0.842,12,69,81,49,21,8,23,60,254,HOU,2022
620,David Nwaba,29,46,4,609,85,176,0.483,15,49,0.306,70,127,0.551,0.526,48,67,0.716,41,110,151,35,28,20,21,55,233,HOU,2022
621,Daniel Theis,29,26,21,584,84,179,0.469,23,79,0.291,61,100,0.610,0.534,27,40,0.675,32,98,130,20,11,17,31,62,218,HOU,2022
622,D.J. Augustin,34,34,2,510,55,136,0.404,39,96,0.406,16,40,0.400,0.548,33,38,0.868,7,34,41,74,10,0,45,17,182,HOU,2022
623,Dennis Schröder,28,15,4,404,55,140,0.393,19,58,0.328,36,82,0.439,0.461,34,39,0.872,6,44,50,88,12,3,39,38,163,HOU,2022
624,Daishen Nix,19,24,0,261,27,67,0.403,7,26,0.269,20,41,0.488,0.455,16,30,0.533,7,26,33,40,15,0,26,21,77,HOU,2022
625,Usman Garuba,19,24,2,239,19,44,0.432,5,20,0.250,14,24,0.583,0.489,5,7,0.714,21,62,83,17,10,11,6,28,48,HOU,2022
626,Danuel House Jr.,28,16,1,233,25,74,0.338,10,34,0.294,15,40,0.375,0.405,17,19,0.895,4,39,43,19,5,5,18,16,77,HOU,2022
627,Bruno Fernando,23,10,0,94,29,41,0.707,0,1,0.000,29,40,0.725,0.707,11,19,0.579,11,29,40,3,1,8,9,18,69,HOU,2022
628,Trevelin Queen,24,10,0,74,15,33,0.455,9,24,0.375,6,9,0.667,0.591,4,4,1.000,7,9,16,4,5,1,7,6,43,HOU,2022
629,Tyrese Maxey,21,75,74,2650,483,995,0.485,132,309,0.427,351,686,0.512,0.552,213,246,0.866,26,214,240,321,55,32,88,156,1311,PHI,2022
630,Tobias Harris,29,73,73,2543,493,1022,0.482,101,275,0.367,392,747,0.525,0.532,170,202,0.842,77,419,496,252,47,43,116,164,1257,PHI,2022
631,Joel Embiid,27,68,68,2297,666,1334,0.499,93,251,0.371,573,1083,0.529,0.534,654,803,0.814,146,650,796,284,77,99,214,181,2079,PHI,2022
632,Georges Niang,28,76,7,1736,246,563,0.437,156,387,0.403,90,176,0.511,0.575,52,59,0.881,25,178,203,102,30,13,59,190,700,PHI,2022
633,Matisse Thybulle,24,66,50,1685,150,300,0.500,45,144,0.313,105,156,0.673,0.575,34,43,0.791,42,109,151,75,115,71,39,158,379,PHI,2022
634,Seth Curry,31,45,45,1566,256,528,0.485,100,250,0.400,156,278,0.561,0.580,64,73,0.877,17,134,151,181,36,11,84,101,676,PHI,2022
635,Furkan Korkmaz,24,67,19,1414,182,470,0.387,77,266,0.289,105,204,0.515,0.469,68,84,0.810,22,153,175,127,33,9,48,58,509,PHI,2022
636,Danny Green,34,62,28,1353,126,320,0.394,103,271,0.380,23,49,0.469,0.555,11,14,0.786,32,125,157,64,60,37,45,105,366,PHI,2022
637,Shake Milton,25,55,6,1179,173,403,0.429,43,133,0.323,130,270,0.481,0.483,61,73,0.836,30,112,142,139,28,17,44,99,450,PHI,2022
638,Andre Drummond,28,49,12,902,128,238,0.538,0,2,0.000,128,236,0.542,0.538,42,82,0.512,136,297,433,97,56,45,79,121,298,PHI,2022
639,James Harden,32,21,21,792,115,286,0.402,46,141,0.326,69,145,0.476,0.483,166,186,0.892,13,136,149,220,26,5,72,48,442,PHI,2022
640,Isaiah Joe,22,55,1,609,62,177,0.350,45,135,0.333,17,42,0.405,0.477,29,31,0.935,6,50,56,35,14,3,19,47,198,PHI,2022
641,Paul Reed,22,38,2,302,54,96,0.563,2,8,0.250,52,88,0.591,0.573,6,14,0.429,44,48,92,16,33,14,10,57,116,PHI,2022
642,DeAndre Jordan,33,16,1,214,32,54,0.593,0,0,,32,54,0.593,0.593,10,14,0.714,32,60,92,8,2,9,16,21,74,PHI,2022
643,Charles Bassey,21,23,0,168,30,47,0.638,0,4,0.000,30,43,0.698,0.638,9,12,0.750,22,40,62,7,5,17,8,32,69,PHI,2022
644,Charlie Brown Jr.,24,19,2,162,9,34,0.265,1,9,0.111,8,25,0.320,0.279,9,10,0.900,14,17,31,5,8,3,5,16,28,PHI,2022
645,Paul Millsap,36,9,1,106,13,30,0.433,2,8,0.250,11,22,0.500,0.467,5,7,0.714,12,13,25,5,5,2,8,19,33,PHI,2022
646,Myles Powell,24,11,0,52,5,17,0.294,1,6,0.167,4,11,0.364,0.324,2,2,1.000,1,5,6,3,1,0,3,8,13,PHI,2022
647,Tyler Johnson,29,3,0,38,4,10,0.400,3,7,0.429,1,3,0.333,0.550,0,0,,1,5,6,2,1,1,1,4,11,PHI,2022
648,Aaron Henry,22,6,0,17,1,5,0.200,0,1,0.000,1,4,0.250,0.200,0,0,,0,1,1,0,0,2,2,2,2,PHI,2022
649,Braxton Key,24,2,0,6,1,2,0.500,0,1,0.000,1,1,1.000,0.500,0,0,,1,1,2,1,1,0,2,1,2,PHI,2022
650,Jaden Springer,19,2,0,6,1,1,1.000,0,0,,1,1,1.000,1.000,0,0,,1,1,2,0,0,2,1,0,2,PHI,2022
651,Willie Cauley-Stein,28,2,0,6,0,0,,0,0,,0,0,,,0,0,,0,2,2,1,0,0,0,2,0,PHI,2022
652,Jayson Tatum,23,76,76,2731,708,1564,0.453,230,651,0.353,478,913,0.524,0.526,400,469,0.853,85,524,609,334,75,49,217,174,2046,BOS,2022
653,Marcus Smart,27,71,71,2296,300,718,0.418,119,360,0.331,181,358,0.506,0.501,142,179,0.793,42,228,270,417,119,18,159,160,861,BOS,2022
654,Jaylen Brown,25,66,66,2220,576,1217,0.473,166,464,0.358,410,753,0.544,0.541,241,318,0.758,53,351,404,231,70,18,178,163,1559,BOS,2022
655,Al Horford,35,69,69,2005,266,569,0.467,89,265,0.336,177,304,0.582,0.546,80,95,0.842,108,422,530,232,49,92,65,130,701,BOS,2022
656,Grant Williams,23,77,21,1875,205,432,0.475,106,258,0.411,99,174,0.569,0.597,86,95,0.905,64,210,274,78,38,57,62,186,602,BOS,2022
657,Robert Williams,24,61,61,1804,271,368,0.736,0,1,0.000,271,367,0.738,0.736,65,90,0.722,238,350,588,121,56,134,63,137,607,BOS,2022
658,Dennis Schröder,28,49,25,1433,257,584,0.440,67,192,0.349,190,392,0.485,0.497,123,145,0.848,28,136,164,208,41,5,104,116,704,BOS,2022
659,Josh Richardson,28,44,0,1087,152,343,0.443,62,156,0.397,90,187,0.481,0.534,61,71,0.859,26,99,125,66,34,23,39,82,427,BOS,2022
660,Payton Pritchard,24,71,2,1001,160,373,0.429,101,245,0.412,59,128,0.461,0.564,21,21,1.000,32,102,134,139,25,6,41,61,442,BOS,2022
661,Romeo Langford,22,44,5,728,79,184,0.429,29,83,0.349,50,101,0.495,0.508,20,34,0.588,30,74,104,19,21,16,16,46,207,BOS,2022
662,Derrick White,27,26,4,713,94,230,0.409,34,111,0.306,60,119,0.504,0.483,64,75,0.853,13,75,88,92,15,16,32,56,286,BOS,2022
663,Aaron Nesmith,22,52,3,574,72,182,0.396,31,115,0.270,41,67,0.612,0.481,21,26,0.808,15,74,89,22,20,5,31,70,196,BOS,2022
664,Enes Freedom,29,35,1,411,51,97,0.526,2,5,0.400,49,92,0.533,0.536,24,28,0.857,61,99,160,8,5,14,20,42,128,BOS,2022
665,Daniel Theis,29,21,6,393,67,112,0.598,10,28,0.357,57,84,0.679,0.643,22,32,0.688,27,71,98,21,9,14,15,49,166,BOS,2022
666,Sam Hauser,24,26,0,158,23,50,0.460,19,44,0.432,4,6,0.667,0.650,0,0,,5,24,29,10,1,2,2,7,65,BOS,2022
667,Jabari Parker,26,12,0,112,18,38,0.474,8,16,0.500,10,22,0.455,0.579,9,9,1.000,5,23,28,6,4,1,8,13,53,BOS,2022
668,Juancho Hernangómez,26,18,0,96,5,27,0.185,3,18,0.167,2,9,0.222,0.241,6,9,0.667,9,16,25,3,4,2,6,7,19,BOS,2022
669,Luke Kornet,26,12,0,85,12,21,0.571,0,4,0.000,12,17,0.706,0.571,2,3,0.667,10,15,25,8,3,2,0,7,26,BOS,2022
670,Brodric Thomas,25,12,0,60,8,18,0.444,2,9,0.222,6,9,0.667,0.500,3,5,0.600,2,8,10,11,1,1,6,7,21,BOS,2022
671,Bruno Fernando,23,20,0,58,7,14,0.500,1,1,1.000,6,13,0.462,0.536,4,5,0.800,7,8,15,4,0,3,5,6,19,BOS,2022
672,Malik Fitts,24,8,0,28,6,10,0.600,3,6,0.500,3,4,0.750,0.750,0,0,,2,5,7,5,0,0,0,1,15,BOS,2022
673,Nik Stauskas,28,6,0,15,2,6,0.333,2,6,0.333,0,0,,0.500,1,2,0.500,0,0,0,1,0,0,1,0,7,BOS,2022
674,Kelan Martin,26,3,0,6,0,3,0.000,0,1,0.000,0,2,0.000,0.000,0,0,,1,1,2,0,0,0,0,0,0,BOS,2022
675,Matt Ryan,24,1,0,5,1,5,0.200,1,5,0.200,0,0,,0.300,0,0,,0,0,0,0,1,0,0,0,3,BOS,2022
676,Juwan Morgan,24,1,0,4,0,0,,0,0,,0,0,,,0,0,,0,0,0,0,0,0,0,0,0,BOS,2022
677,C.J. Miles,34,1,0,2,0,0,,0,0,,0,0,,,0,0,,0,0,0,0,0,0,0,1,0,BOS,2022
678,Joe Johnson,40,1,0,2,1,1,1.000,0,0,,1,1,1.000,1.000,0,0,,0,0,0,0,0,0,0,0,2,BOS,2022
679,Justin Jackson,26,1,0,2,0,1,0.000,0,0,,0,1,0.000,0.000,2,2,1.000,0,0,0,0,0,0,0,0,2,BOS,2022
680,Julius Randle,27,72,72,2544,512,1246,0.411,120,390,0.308,392,856,0.458,0.459,303,401,0.756,125,591,716,370,53,39,245,205,1447,NYK,2022
681,RJ Barrett,21,70,70,2417,487,1194,0.408,138,404,0.342,349,790,0.442,0.466,290,406,0.714,66,342,408,208,43,16,151,142,1402,NYK,2022
682,Evan Fournier,29,80,80,2358,402,965,0.417,241,619,0.389,161,346,0.465,0.541,80,113,0.708,34,176,210,171,79,20,105,180,1125,NYK,2022
683,Alec Burks,30,81,44,2318,285,728,0.391,157,389,0.404,128,339,0.378,0.499,217,264,0.822,47,350,397,239,85,26,91,215,944,NYK,2022
684,Mitchell Robinson,23,72,62,1848,261,343,0.761,0,0,,261,343,0.761,0.761,88,181,0.486,295,322,617,38,58,133,60,195,610,NYK,2022
685,Immanuel Quickley,22,78,3,1802,284,724,0.392,137,396,0.346,147,328,0.448,0.487,177,201,0.881,31,216,247,275,54,3,99,167,882,NYK,2022
686,Obi Toppin,23,72,10,1230,251,473,0.531,52,169,0.308,199,304,0.655,0.586,94,124,0.758,69,199,268,77,25,33,56,102,648,NYK,2022
687,Kemba Walker,31,37,37,948,149,370,0.403,73,199,0.367,76,171,0.444,0.501,60,71,0.845,14,97,111,131,26,7,48,37,431,NYK,2022
688,Taj Gibson,36,52,4,946,86,166,0.518,15,38,0.395,71,128,0.555,0.563,42,52,0.808,88,141,229,32,22,40,27,137,229,NYK,2022
689,Quentin Grimes,21,46,6,786,95,235,0.404,72,189,0.381,23,46,0.500,0.557,13,19,0.684,24,70,94,44,31,11,28,72,275,NYK,2022
690,Derrick Rose,33,26,4,636,122,274,0.445,37,92,0.402,85,182,0.467,0.513,30,31,0.968,21,57,78,103,22,12,39,15,311,NYK,2022
691,Nerlens Noel,27,25,11,562,32,60,0.533,0,3,0.000,32,57,0.561,0.533,21,30,0.700,48,93,141,23,30,31,20,67,85,NYK,2022
692,Jericho Sims,23,41,5,555,39,54,0.722,0,0,,39,54,0.722,0.722,12,29,0.414,61,108,169,21,11,22,20,66,90,NYK,2022
693,Miles McBride,21,40,2,372,32,108,0.296,17,68,0.250,15,40,0.375,0.375,8,12,0.667,4,38,42,41,14,1,5,45,89,NYK,2022
694,Cam Reddish,22,15,0,215,27,65,0.415,8,31,0.258,19,34,0.559,0.477,29,32,0.906,5,16,21,10,12,4,13,15,91,NYK,2022
695,Kevin Knox,22,13,0,111,15,40,0.375,10,28,0.357,5,12,0.417,0.500,7,10,0.700,8,14,22,3,2,1,5,5,47,NYK,2022
696,Ryan Arcidiacono,27,10,0,76,6,12,0.500,4,9,0.444,2,3,0.667,0.667,0,0,,0,8,8,4,1,0,3,5,16,NYK,2022
697,Damyean Dotson,27,2,0,21,2,4,0.500,0,1,0.000,2,3,0.667,0.500,0,0,,0,2,2,1,0,0,0,0,4,NYK,2022
698,Wayne Selden,27,3,0,19,1,4,0.250,1,2,0.500,0,2,0.000,0.375,2,4,0.500,0,1,1,1,0,0,0,1,5,NYK,2022
699,Feron Hunt,22,2,0,8,0,2,0.000,0,0,,0,2,0.000,0.000,0,0,,1,0,1,1,1,0,1,1,0,NYK,2022
700,Danuel House Jr.,28,1,0,3,0,1,0.000,0,1,0.000,0,0,,0.000,0,0,,0,0,0,0,0,0,0,0,0,NYK,2022
701,Matt Mooney,24,1,0,2,0,1,0.000,0,1,0.000,0,0,,0.000,0,0,,0,0,0,0,1,0,1,0,0,NYK,2022
702,Tyler Hall,24,1,0,2,0,0,,0,0,,0,0,,,0,0,,0,0,0,0,0,0,0,0,0,NYK,2022
703,Patty Mills,33,81,48,2346,324,794,0.408,227,568,0.400,97,226,0.429,0.551,48,59,0.814,18,138,156,183,51,17,73,112,923,BRK,2022
704,Kevin Durant,33,55,55,2047,578,1115,0.518,115,300,0.383,463,815,0.568,0.570,372,409,0.910,29,378,407,351,48,52,191,113,1643,BRK,2022
705,Bruce Brown,25,72,45,1774,256,506,0.506,38,94,0.404,218,412,0.529,0.543,97,128,0.758,100,245,345,148,77,52,56,176,647,BRK,2022
706,James Harden,32,44,44,1627,292,706,0.414,102,307,0.332,190,399,0.476,0.486,304,350,0.869,42,309,351,447,56,31,212,105,990,BRK,2022
707,James Johnson,34,62,10,1191,144,307,0.469,23,85,0.271,121,222,0.545,0.507,29,55,0.527,51,164,215,130,30,34,48,162,340,BRK,2022
708,Cam Thomas,20,67,2,1176,218,503,0.433,47,174,0.270,171,329,0.520,0.480,87,105,0.829,16,145,161,78,33,8,55,66,570,BRK,2022
709,Kyrie Irving,29,29,29,1091,289,616,0.469,100,239,0.418,189,377,0.501,0.550,118,129,0.915,16,111,127,167,41,17,73,81,796,BRK,2022
1,Jalen Green,20,76,76,2602,566,1359,0.416,187,554,0.338,379,805,0.471,0.485,364,463,0.786,43,241,284,281,59,18,200,131,1683,HOU,2023
2,Jabari Smith Jr.,19,79,79,2451,364,892,0.408,120,391,0.307,244,501,0.487,0.475,162,206,0.786,122,447,569,101,43,74,104,227,1010,HOU,2023
3,Kenyon Martin Jr.,22,82,49,2292,410,720,0.569,68,216,0.315,342,504,0.679,0.617,151,222,0.680,126,326,452,123,41,30,91,147,1039,HOU,2023
4,Alperen Şengün,20,75,72,2171,442,799,0.553,19,57,0.333,423,742,0.570,0.565,206,288,0.715,242,436,678,291,70,70,193,258,1109,HOU,2023
5,Kevin Porter Jr.,22,59,59,2024,391,884,0.442,141,385,0.366,250,499,0.501,0.522,207,264,0.784,76,238,314,338,82,17,188,156,1130,HOU,2023
6,Tari Eason,21,82,5,1767,296,660,0.448,59,172,0.343,237,488,0.486,0.493,109,145,0.752,195,301,496,88,96,47,101,189,760,HOU,2023
7,Eric Gordon,34,47,47,1418,210,478,0.439,85,245,0.347,125,233,0.536,0.528,110,135,0.815,12,85,97,136,30,17,83,45,615,HOU,2023
8,Usman Garuba,20,75,1,970,86,177,0.486,24,59,0.407,62,118,0.525,0.554,29,47,0.617,120,187,307,64,44,29,47,135,225,HOU,2023
9,Daishen Nix,20,57,7,914,81,237,0.342,40,140,0.286,41,97,0.423,0.426,24,36,0.667,18,80,98,132,31,7,86,59,226,HOU,2023
10,Josh Christopher,21,64,2,786,153,329,0.465,21,89,0.236,132,240,0.550,0.497,45,60,0.750,20,51,71,73,33,15,60,59,372,HOU,2023
11,Jae'Sean Tate,27,31,7,677,110,229,0.480,13,46,0.283,97,183,0.530,0.509,50,69,0.725,41,77,118,84,21,7,47,106,283,HOU,2023
12,Garrison Mathews,26,45,0,602,60,170,0.353,53,155,0.342,7,15,0.467,0.509,41,45,0.911,10,52,62,23,23,4,18,56,214,HOU,2023
13,TyTy Washington Jr.,21,31,2,433,58,160,0.363,19,80,0.238,39,80,0.488,0.422,10,18,0.556,2,43,45,47,15,2,14,29,145,HOU,2023
14,Bruno Fernando,24,31,4,364,48,93,0.516,0,1,0.000,48,92,0.522,0.516,30,44,0.682,48,74,122,30,6,31,20,68,126,HOU,2023
15,Boban Marjanović,34,31,0,171,41,60,0.683,0,1,0.000,41,59,0.695,0.683,20,27,0.741,20,40,60,9,5,2,14,10,102,HOU,2023
16,Frank Kaminsky,29,10,0,59,6,19,0.316,2,10,0.200,4,9,0.444,0.368,4,4,1.000,4,12,16,11,1,3,0,1,18,HOU,2023
17,Trevor Hudgins,23,5,0,28,2,9,0.222,2,8,0.250,0,1,0.000,0.333,3,3,1.000,0,0,0,3,0,0,1,1,9,HOU,2023
18,Darius Days,23,4,0,25,5,12,0.417,3,10,0.300,2,2,1.000,0.542,2,2,1.000,1,5,6,1,0,1,0,2,15,HOU,2023
19,Tobias Harris,30,74,74,2436,423,845,0.501,126,324,0.389,297,521,0.570,0.575,113,129,0.876,67,357,424,186,68,40,89,149,1085,PHI,2023
20,Joel Embiid,28,66,66,2284,728,1328,0.548,66,200,0.330,662,1128,0.587,0.573,661,771,0.857,113,557,670,274,66,112,226,205,2183,PHI,2023
21,De'Anthony Melton,24,77,58,2150,277,651,0.425,157,403,0.390,120,248,0.484,0.546,69,87,0.793,69,243,312,197,126,41,102,191,780,PHI,2023
22,James Harden,33,58,58,2135,371,842,0.441,161,418,0.385,210,424,0.495,0.536,313,361,0.867,40,314,354,618,71,31,195,112,1216,PHI,2023
23,Tyrese Maxey,22,60,41,2016,439,913,0.481,160,369,0.434,279,544,0.513,0.568,180,213,0.845,23,153,176,212,49,8,80,132,1218,PHI,2023
24,P.J. Tucker,37,75,75,1920,96,225,0.427,55,140,0.393,41,85,0.482,0.549,19,23,0.826,95,200,295,60,39,15,44,180,266,PHI,2023
25,Shake Milton,26,76,11,1567,241,503,0.479,56,148,0.378,185,355,0.521,0.535,99,116,0.853,39,152,191,240,25,13,94,123,637,PHI,2023
26,Georges Niang,29,78,1,1512,222,502,0.442,154,384,0.401,68,118,0.576,0.596,39,45,0.867,19,166,185,77,30,14,54,145,637,PHI,2023
27,Danuel House Jr.,29,56,5,807,93,197,0.472,37,110,0.336,56,87,0.644,0.566,45,60,0.750,9,85,94,44,14,9,26,69,268,PHI,2023
28,Paul Reed,23,69,2,755,124,209,0.593,1,6,0.167,123,203,0.606,0.596,38,51,0.745,112,150,262,27,46,51,45,123,287,PHI,2023
29,Montrezl Harrell,29,57,7,681,125,209,0.598,0,6,0.000,125,203,0.616,0.598,70,101,0.693,67,92,159,33,17,25,35,75,320,PHI,2023
30,Matisse Thybulle,25,49,6,591,50,116,0.431,21,63,0.333,29,53,0.547,0.522,9,12,0.750,20,43,63,23,45,14,8,65,130,PHI,2023
31,Jalen McDaniels,25,24,3,419,60,123,0.488,12,30,0.400,48,93,0.516,0.537,28,34,0.824,19,57,76,19,17,5,13,51,160,PHI,2023
32,Furkan Korkmaz,25,37,0,353,48,111,0.432,18,46,0.391,30,65,0.462,0.514,26,36,0.722,6,36,42,22,10,3,24,18,140,PHI,2023
33,Jaden Springer,20,16,2,89,17,35,0.486,2,5,0.400,15,30,0.500,0.514,6,8,0.750,6,8,14,8,7,3,3,15,42,PHI,2023
34,Dewayne Dedmon,33,8,1,76,13,22,0.591,1,2,0.500,12,20,0.600,0.614,1,5,0.200,6,19,25,10,2,5,6,14,28,PHI,2023
35,Mac McClung,24,2,0,41,9,20,0.450,4,11,0.364,5,9,0.556,0.550,3,5,0.600,3,7,10,9,0,0,3,3,25,PHI,2023
36,Louis King,23,1,0,29,8,13,0.615,4,8,0.500,4,5,0.800,0.769,0,1,0.000,2,2,4,2,1,0,2,4,20,PHI,2023
37,Saben Lee,23,2,0,10,3,4,0.750,0,1,0.000,3,3,1.000,0.750,0,0,,0,0,0,2,1,0,3,1,6,PHI,2023
38,Julian Champagnie,21,2,0,7,0,2,0.000,0,1,0.000,0,1,0.000,0.000,0,0,,0,0,0,0,1,0,0,0,0,PHI,2023
39,Michael Foster Jr.,20,1,0,1,0,0,,0,0,,0,0,,,0,0,,0,0,0,0,0,0,0,0,0,PHI,2023
40,Jayson Tatum,24,74,74,2732,727,1559,0.466,240,686,0.350,487,873,0.558,0.543,531,622,0.854,78,571,649,342,78,51,213,160,2225,BOS,2023
41,Jaylen Brown,26,67,67,2405,679,1383,0.491,163,487,0.335,516,896,0.576,0.550,263,344,0.765,78,381,459,232,75,26,197,172,1784,BOS,2023
42,Derrick White,28,82,70,2319,350,758,0.462,149,391,0.381,201,367,0.548,0.560,168,192,0.875,52,241,293,321,54,76,95,177,1017,BOS,2023
43,Grant Williams,24,79,23,2045,216,476,0.454,115,291,0.395,101,185,0.546,0.575,94,122,0.770,87,276,363,131,41,31,82,192,641,BOS,2023
44,Marcus Smart,28,61,61,1957,250,602,0.415,115,342,0.336,135,260,0.519,0.511,88,118,0.746,46,145,191,382,93,23,143,172,703,BOS,2023
45,Al Horford,36,63,63,1922,228,479,0.476,145,325,0.446,83,154,0.539,0.627,15,21,0.714,73,317,390,189,30,61,37,121,616,BOS,2023
46,Malcolm Brogdon,30,67,0,1744,354,732,0.484,132,297,0.444,222,435,0.510,0.574,160,184,0.870,42,238,280,248,45,18,98,109,1000,BOS,2023
47,Sam Hauser,25,80,8,1290,180,396,0.455,140,335,0.418,40,61,0.656,0.631,12,17,0.706,35,169,204,71,29,21,30,99,512,BOS,2023
48,Robert Williams,25,35,20,824,127,170,0.747,0,1,0.000,127,169,0.751,0.747,25,41,0.610,104,188,292,50,22,48,34,68,279,BOS,2023
49,Luke Kornet,27,69,0,804,113,170,0.665,3,13,0.231,110,157,0.701,0.674,32,39,0.821,86,111,197,53,11,46,25,81,261,BOS,2023
50,Payton Pritchard,25,48,3,643,101,245,0.412,56,154,0.364,45,91,0.495,0.527,12,16,0.750,25,63,88,64,14,1,40,37,270,BOS,2023
51,Blake Griffin,33,41,16,569,63,130,0.485,23,66,0.348,40,64,0.625,0.573,21,32,0.656,47,108,155,61,14,9,22,75,170,BOS,2023
52,Mike Muscala,31,20,4,323,42,89,0.472,25,65,0.385,17,24,0.708,0.612,9,13,0.692,14,54,68,12,4,5,9,28,118,BOS,2023
53,Noah Vonleh,27,23,1,171,11,24,0.458,1,4,0.250,10,20,0.500,0.479,2,2,1.000,18,30,48,7,2,8,11,35,25,BOS,2023
54,Justin Jackson,27,23,0,107,7,27,0.259,5,20,0.250,2,7,0.286,0.352,1,2,0.500,2,15,17,9,4,4,2,7,20,BOS,2023
55,JD Davison,20,12,0,66,8,19,0.421,2,7,0.286,6,12,0.500,0.474,1,2,0.500,2,7,9,11,2,2,4,5,19,BOS,2023
56,Mfiondu Kabengele,25,4,0,36,2,7,0.286,0,3,0.000,2,4,0.500,0.286,2,2,1.000,5,5,10,0,2,0,1,3,6,BOS,2023
57,Justin Champagnie,21,2,0,23,2,12,0.167,1,5,0.200,1,7,0.143,0.208,0,0,,2,2,4,3,1,0,0,1,5,BOS,2023
58,Julius Randle,28,77,77,2737,658,1432,0.459,218,636,0.343,440,796,0.553,0.536,402,531,0.757,141,626,767,316,49,21,216,233,1936,NYK,2023
59,RJ Barrett,22,73,73,2475,510,1176,0.434,121,390,0.310,389,786,0.495,0.485,290,392,0.740,60,308,368,201,31,15,164,179,1431,NYK,2023
60,Jalen Brunson,26,68,68,2379,587,1195,0.491,134,322,0.416,453,873,0.519,0.547,325,392,0.829,40,201,241,421,61,15,142,152,1633,NYK,2023
61,Immanuel Quickley,23,81,21,2344,419,936,0.448,168,454,0.370,251,482,0.521,0.537,203,248,0.819,58,279,337,279,80,14,100,166,1209,NYK,2023
62,Quentin Grimes,22,71,66,2121,282,602,0.468,157,407,0.386,125,195,0.641,0.599,78,98,0.796,49,180,229,150,47,26,69,177,799,NYK,2023
63,Isaiah Hartenstein,24,82,8,1626,175,327,0.535,8,37,0.216,167,290,0.576,0.547,48,71,0.676,209,327,536,102,53,64,66,213,406,NYK,2023
64,Mitchell Robinson,24,59,58,1591,188,280,0.671,0,0,,188,280,0.671,0.671,59,122,0.484,267,288,555,53,56,109,41,160,435,NYK,2023
65,Obi Toppin,24,67,5,1050,187,419,0.446,85,247,0.344,102,172,0.593,0.548,38,47,0.809,29,158,187,66,23,12,38,68,497,NYK,2023
66,Jericho Sims,24,52,16,812,83,107,0.776,0,1,0.000,83,106,0.783,0.776,12,16,0.750,99,143,242,25,15,28,27,96,178,NYK,2023
67,Miles McBride,22,64,2,760,77,215,0.358,40,134,0.299,37,81,0.457,0.451,28,42,0.667,13,37,50,72,37,8,25,60,222,NYK,2023
68,Josh Hart,27,25,1,750,92,157,0.586,27,52,0.519,65,105,0.619,0.672,45,57,0.789,47,129,176,90,34,12,38,62,256,NYK,2023
69,Evan Fournier,30,27,7,459,56,166,0.337,35,114,0.307,21,52,0.404,0.443,18,21,0.857,4,45,49,36,16,3,22,46,165,NYK,2023
70,Cam Reddish,23,20,8,438,61,136,0.449,17,56,0.304,44,80,0.550,0.511,29,33,0.879,7,24,31,20,15,8,15,32,168,NYK,2023
71,Derrick Rose,34,27,0,338,61,159,0.384,19,63,0.302,42,96,0.438,0.443,11,12,0.917,8,32,40,46,7,5,22,18,152,NYK,2023
72,Svi Mykhailiuk,25,13,0,40,6,12,0.500,6,10,0.600,0,2,0.000,0.750,3,5,0.600,0,7,7,1,1,0,2,1,21,NYK,2023
73,Ryan Arcidiacono,28,11,0,26,1,5,0.200,1,3,0.333,0,2,0.000,0.300,0,0,,0,4,4,2,2,0,1,3,3,NYK,2023
74,Trevor Keels,19,3,0,8,1,4,0.250,1,4,0.250,0,0,,0.375,0,0,,0,2,2,0,0,0,0,0,3,NYK,2023
75,Royce O'Neale,29,76,53,2409,229,593,0.386,163,419,0.389,66,174,0.379,0.524,50,69,0.725,55,329,384,283,65,49,114,239,671,BRK,2023
76,Nic Claxton,23,76,76,2271,414,587,0.705,0,2,0.000,414,585,0.708,0.705,133,246,0.541,184,518,702,144,65,189,96,212,961,BRK,2023
77,Joe Harris,31,74,33,1527,201,440,0.457,142,333,0.426,59,107,0.551,0.618,18,28,0.643,23,141,164,101,34,13,41,140,562,BRK,2023
78,Kyrie Irving,30,40,40,1478,398,819,0.486,130,348,0.374,268,471,0.569,0.565,158,179,0.883,38,166,204,211,41,33,91,109,1084,BRK,2023
79,Kevin Durant,34,39,39,1403,410,734,0.559,71,189,0.376,339,545,0.622,0.607,267,286,0.934,14,248,262,207,32,57,136,92,1158,BRK,2023
80,Seth Curry,32,61,7,1211,208,449,0.463,94,232,0.405,114,217,0.525,0.568,51,55,0.927,13,87,100,99,36,7,51,96,561,BRK,2023
81,Ben Simmons,26,42,33,1105,133,235,0.566,0,2,0.000,133,233,0.571,0.566,25,57,0.439,40,223,263,256,54,24,97,139,291,BRK,2023
82,Cam Thomas,21,57,4,948,201,456,0.441,51,133,0.383,150,323,0.464,0.497,151,174,0.868,8,87,95,78,20,7,63,55,604,BRK,2023
83,Yuta Watanabe,28,58,1,928,114,232,0.491,60,135,0.444,54,97,0.557,0.621,34,47,0.723,30,111,141,48,25,17,22,80,322,BRK,2023
84,Mikal Bridges,26,27,27,923,239,503,0.475,68,181,0.376,171,322,0.531,0.543,160,179,0.894,23,98,121,72,26,16,49,44,706,BRK,2023
85,Spencer Dinwiddie,29,26,26,917,144,356,0.404,43,149,0.289,101,207,0.488,0.465,98,123,0.797,9,98,107,236,28,8,55,63,429,BRK,2023
86,Cameron Johnson,26,25,25,770,141,301,0.468,58,156,0.372,83,145,0.572,0.565,74,87,0.851,20,100,120,52,35,8,27,54,414,BRK,2023
87,Edmond Sumner,27,53,12,736,124,269,0.461,31,87,0.356,93,182,0.511,0.519,99,108,0.917,13,66,79,68,31,10,50,83,378,BRK,2023
88,Dorian Finney-Smith,29,26,26,721,67,191,0.351,37,121,0.306,30,70,0.429,0.448,15,19,0.789,47,81,128,41,17,16,26,64,186,BRK,2023
89,Patty Mills,34,40,2,567,86,209,0.411,49,134,0.366,37,75,0.493,0.529,25,30,0.833,8,36,44,56,15,3,30,32,246,BRK,2023
90,Day'Ron Sharpe,21,48,3,552,93,171,0.544,6,11,0.545,87,160,0.544,0.561,35,55,0.636,99,101,200,37,15,32,42,89,227,BRK,2023
91,T.J. Warren,29,26,0,490,102,200,0.510,16,48,0.333,86,152,0.566,0.550,27,33,0.818,13,59,72,29,15,7,17,45,247,BRK,2023
92,Markieff Morris,33,27,1,285,33,82,0.402,20,49,0.408,13,33,0.394,0.524,10,10,1.000,13,46,59,25,8,5,14,33,96,BRK,2023
93,David Duke Jr.,23,23,0,228,36,78,0.462,1,12,0.083,35,66,0.530,0.468,12,17,0.706,11,18,29,21,10,1,18,31,85,BRK,2023
94,Dru Smith,25,10,0,91,13,31,0.419,4,13,0.308,9,18,0.500,0.484,3,3,1.000,1,14,15,17,6,1,2,13,33,BRK,2023
95,Kessler Edwards,22,14,1,79,6,24,0.250,2,12,0.167,4,12,0.333,0.292,1,2,0.500,6,8,14,2,3,1,4,3,15,BRK,2023
96,Nerlens Noel,28,3,1,43,1,6,0.167,0,0,,1,6,0.167,0.167,1,2,0.500,3,6,9,3,3,1,5,7,3,BRK,2023
97,RaiQuan Gray,23,1,0,35,6,12,0.500,2,5,0.400,4,7,0.571,0.583,2,2,1.000,3,6,9,7,0,1,4,5,16,BRK,2023
98,Moses Brown,23,2,0,6,0,0,,0,0,,0,0,,,0,0,,0,0,0,0,1,0,1,1,0,BRK,2023
99,Alondes Williams,23,1,0,5,0,0,,0,0,,0,0,,,0,0,,0,1,1,0,0,0,2,1,0,BRK,2023
100,Scottie Barnes,21,77,76,2678,463,1016,0.456,63,224,0.281,400,792,0.505,0.487,190,246,0.772,179,333,512,371,83,61,154,170,1179,TOR,2023
